Date,Negative,Positive,Neutral,Total,Percentage_neg,Percentage_pos,Percentage_neutr
2015-10-01,394,672,1696,2762,14.265025343953658,24.33019551049964,61.404779145546705
2015-10-02,340,633,1595,2568,13.239875389408098,24.649532710280376,62.110591900311526
2015-10-03,226,360,1067,1653,13.67211131276467,21.77858439201452,64.54930429522081
2015-10-04,239,420,1046,1705,14.017595307917889,24.633431085043988,61.348973607038126
2015-10-05,319,620,1060,1999,15.957978989494748,31.015507753876935,53.02651325662831
2015-10-06,451,653,1224,2328,19.372852233676976,28.04982817869416,52.57731958762887
2015-10-07,468,556,1278,2302,20.330147697654212,24.152910512597742,55.516941789748046
2015-10-08,457,664,1675,2796,16.3447782546495,23.74821173104435,59.90701001430615
2015-10-09,490,626,1719,2835,17.28395061728395,22.081128747795415,60.63492063492063
2015-10-10,316,482,1323,2121,14.898632720414899,22.725129655822727,62.37623762376238
2015-10-11,279,693,1701,2673,10.437710437710438,25.925925925925924,63.63636363636363
2015-10-12,369,761,1635,2765,13.345388788426762,27.522603978300182,59.13200723327306
2015-10-13,593,718,1757,3068,19.328552803129075,23.402868318122554,57.268578878748365
2015-10-14,701,1479,2514,4694,14.933958244567533,31.508308478909246,53.55773327652322
2015-10-15,481,632,1547,2660,18.08270676691729,23.759398496240603,58.15789473684211
2015-10-16,898,651,1940,3489,25.738033820578966,18.658641444539985,55.603324734881056
2015-10-17,406,543,1850,2799,14.505180421579137,19.39978563772776,66.0950339406931
2015-10-18,380,493,1569,2442,15.561015561015562,20.18837018837019,64.25061425061425
2015-10-19,650,1051,2283,3984,16.315261044176708,26.380522088353413,57.30421686746988
2015-10-20,540,873,1496,2909,18.563080096253007,30.010312822275697,51.426607081471296
2015-10-21,665,854,1445,2964,22.435897435897438,28.81241565452092,48.75168690958165
2015-10-22,476,802,2150,3428,13.885647607934656,23.39556592765461,62.718786464410734
2015-10-23,704,898,2692,4294,16.39496972519795,20.912901723334887,62.692128551467164
2015-10-24,355,657,1727,2739,12.960934647681635,23.986856516977,63.05220883534136
2015-10-25,374,452,1171,1997,18.728092138207312,22.633950926389584,58.6379569354031
2015-10-26,546,717,1491,2754,19.825708061002178,26.034858387799563,54.13943355119826
2015-10-27,592,666,1935,3193,18.540557469464453,20.85812715314751,60.60131537738803
2015-10-28,504,1401,1972,3877,12.999742068609748,36.136187774052104,50.86407015733815
2015-10-29,444,755,2121,3320,13.373493975903614,22.740963855421686,63.885542168674704
2015-10-30,543,831,2337,3711,14.632174616006468,22.392886014551333,62.9749393694422
2015-10-31,486,617,1663,2766,17.570498915401302,22.30657989877079,60.12292118582791
2015-11-01,608,620,1286,2514,24.184566428003183,24.66189339697693,51.153540175019884
2015-11-02,892,909,2809,4610,19.34924078091106,19.718004338394792,60.93275488069414
2015-11-03,666,951,2504,4121,16.16112594030575,23.076923076923077,60.761950982771175
2015-11-04,444,1120,2090,3654,12.151067323481117,30.65134099616858,57.1975916803503
2015-11-05,965,1714,2395,5074,19.018525817895153,33.78005518328735,47.2014189988175
2015-11-06,772,1488,2554,4814,16.036560033236395,30.909846281678437,53.05359368508517
2015-11-07,530,769,1927,3226,16.429014259144452,23.83756974581525,59.733415995040296
2015-11-08,459,535,1679,2673,17.17171717171717,20.014964459408905,62.81331836887393
2015-11-09,821,749,2396,3966,20.70095814422592,18.885526979324258,60.413514876449824
2015-11-10,781,1021,2308,4110,19.002433090024333,24.84184914841849,56.15571776155718
2015-11-11,641,959,2174,3774,16.984631690514043,25.410704822469526,57.604663487016424
2015-11-12,601,841,1706,3148,19.09148665819568,26.715374841168998,54.19313850063533
2015-11-13,435,736,1704,2875,15.130434782608695,25.6,59.2695652173913
2015-11-14,484,741,1553,2778,17.42260619150468,26.673866090712746,55.90352771778257
2015-11-15,640,813,1856,3309,19.34119069205198,24.56935630099728,56.08945300695074
2015-11-16,453,798,1841,3092,14.650711513583442,25.808538163001295,59.54075032341527
2015-11-17,553,872,2449,3874,14.27465152297367,22.509034589571502,63.216313887454824
2015-11-18,488,1058,2172,3718,13.12533620225928,28.456159225389992,58.41850457235073
2015-11-19,454,887,2591,3932,11.546286876907425,22.55849440488301,65.89521871820956
2015-11-20,327,871,1756,2954,11.06973595125254,29.48544346648612,59.444820582261336
2015-11-21,325,568,1513,2406,13.507896924355778,23.60764754779717,62.88445552784705
2015-11-22,298,573,1461,2332,12.778730703259006,24.571183533447684,62.650085763293305
2015-11-23,447,1306,2281,4034,11.08081308874566,32.37481408031731,56.54437283093704
2015-11-24,598,1351,3058,5007,11.94327940882764,26.982224885160775,61.07449570601159
2015-11-25,705,1803,2560,5068,13.910812943962114,35.576164167324386,50.5130228887135
2015-11-26,872,1130,2301,4303,20.264931443179176,26.26074831512898,53.47432024169184
2015-11-27,648,1244,2192,4084,15.866797257590598,30.460333006856022,53.67286973555338
2015-11-28,536,1609,2484,4629,11.579174767768416,34.75912724130482,53.66169799092677
2015-11-29,724,4432,5114,10270,7.049659201557936,43.15481986368062,49.79552093476144
2015-11-30,1721,3299,7639,12659,13.595070700687259,26.06051030887116,60.34441899044158
2015-12-01,1573,2745,6655,10973,14.335186366536043,25.015948236580698,60.64886539688325
2015-12-02,1245,1820,4919,7984,15.593687374749498,22.79559118236473,61.610721442885776
2015-12-03,1174,1627,4137,6938,16.921302969155377,23.45056212164889,59.62813490919573
2015-12-04,1079,1301,3314,5694,18.949771689497716,22.848612574639972,58.20161573586231
2015-12-05,685,1008,3125,4818,14.217517642175176,20.921544209215444,64.86093814860938
2015-12-06,649,899,2322,3870,16.77002583979328,23.22997416020672,60.0
2015-12-07,748,1534,2890,5172,14.462490332559938,29.65970610982212,55.877803557617945
2015-12-08,631,1308,2604,4543,13.889500330178297,28.791547435615232,57.31895223420646
2015-12-09,709,1528,2516,4753,14.916894592888703,32.14811697875027,52.93498842836104
2015-12-10,1222,2096,2861,6179,19.776662890435347,33.9213464961968,46.30199061336786
2015-12-11,1027,2640,3707,7374,13.92731217792243,35.80146460537022,50.27122321670735
2015-12-12,2395,4072,9530,15997,14.971557166968807,25.454772769894358,59.57367006313684
2015-12-13,1375,2785,6316,10476,13.125238640702557,26.58457426498664,60.29018709431081
2015-12-14,1224,2122,4165,7511,16.296099054719747,28.251897217414456,55.452003727865794
2015-12-15,974,2366,3593,6933,14.048752343862686,34.12664070387999,51.82460695225733
2015-12-16,786,1774,3001,5561,14.134148534436253,31.90073727746808,53.96511418809566
2015-12-17,593,1208,2216,4017,14.762260393328356,30.0721931789893,55.16554642768236
2015-12-18,588,1011,2126,3725,15.78523489932886,27.140939597315437,57.0738255033557
2015-12-19,523,879,1426,2828,18.493635077793495,31.082036775106083,50.424328147100425
2015-12-20,393,708,1319,2420,16.239669421487605,29.256198347107436,54.50413223140495
2015-12-21,631,1036,1881,3548,17.784667418263812,29.19954904171364,53.01578354002254
2015-12-22,673,1248,2195,4116,16.350826044703595,30.32069970845481,53.328474246841594
2015-12-23,744,1448,2315,4507,16.507654759263367,32.12780119813623,51.3645440426004
2015-12-24,1279,2657,4313,8249,15.504909686022547,32.20996484422354,52.285125469753915
2015-12-25,1057,1288,2195,4540,23.281938325991188,28.370044052863435,48.348017621145374
2015-12-26,644,1030,1578,3252,19.803198031980322,31.67281672816728,48.523985239852394
2015-12-27,634,954,1549,3137,20.210392094357665,30.411220911699075,49.37838699394326
2015-12-28,709,902,1558,3169,22.372988324392555,28.463237614389396,49.16377406121805
2015-12-29,791,797,1665,3253,24.31601598524439,24.500461112818936,51.183522901936676
2015-12-30,497,662,1384,2543,19.543845851356664,26.03224537947306,54.42390876917027
2015-12-31,480,779,1513,2772,17.316017316017316,28.1024531024531,54.58152958152959
2016-01-01,284,580,1039,1903,14.923804519180242,30.478192327903308,54.598003152916455
2016-01-02,317,406,1048,1771,17.899491812535288,22.92490118577075,59.175607001693955
2016-01-03,277,477,1048,1802,15.37180910099889,26.47058823529412,58.157602663706996
2016-01-04,414,460,1165,2039,20.30407062285434,22.560078469838157,57.13585090730751
2016-01-05,678,588,1260,2526,26.840855106888363,23.27790973871734,49.8812351543943
2016-01-06,576,565,1404,2545,22.63261296660118,22.20039292730845,55.16699410609037
2016-01-07,473,480,1152,2105,22.470308788598576,22.802850356294538,54.726840855106886
2016-01-08,409,530,1037,1976,20.698380566801617,26.821862348178136,52.47975708502024
2016-01-09,275,519,799,1593,17.263025737602007,32.580037664783426,50.15693659761457
2016-01-10,335,511,797,1643,20.389531345100426,31.101643335362144,48.50882531953743
2016-01-11,422,561,912,1895,22.269129287598943,29.604221635883903,48.126649076517154
2016-01-12,391,476,1002,1869,20.92027822364901,25.468164794007492,53.6115569823435
2016-01-13,700,1022,1770,3492,20.04581901489118,29.266895761741125,50.687285223367695
2016-01-14,392,1026,2136,3554,11.029825548677547,28.86888013505909,60.10129431626336
2016-01-15,316,587,2263,3166,9.98104864181933,18.540745420088438,71.47820593809223
2016-01-16,293,449,876,1618,18.10877626699629,27.750309023485787,54.14091470951793
2016-01-17,300,513,1158,1971,15.220700152207002,26.027397260273972,58.75190258751902
2016-01-18,429,855,1892,3176,13.507556675062974,26.920654911838792,59.57178841309824
2016-01-19,370,746,1446,2562,14.441842310694769,29.117876658860265,56.440281030444964
2016-01-20,932,1004,1981,3917,23.793719683431195,25.631861118202703,50.574419198366094
2016-01-21,679,956,1827,3462,19.612940496822645,27.61409589832467,52.772963604852684
2016-01-22,526,813,1881,3220,16.335403726708076,25.248447204968944,58.41614906832299
2016-01-23,622,858,2179,3659,16.99918010385351,23.44902978955999,59.5517901065865
2016-01-24,532,908,1682,3122,17.040358744394617,29.083920563741188,53.875720691864196
2016-01-25,552,928,1697,3177,17.37488196411709,29.209946490399748,53.41517154548316
2016-01-26,470,792,1758,3020,15.562913907284766,26.225165562913904,58.21192052980132
2016-01-27,355,657,1413,2425,14.63917525773196,27.09278350515464,58.2680412371134
2016-01-28,295,491,1364,2150,13.72093023255814,22.837209302325583,63.441860465116285
2016-01-29,269,552,1216,2037,13.205694648993619,27.098674521354933,59.69563082965145
2016-01-30,219,406,863,1488,14.717741935483872,27.284946236559136,57.997311827956985
2016-01-31,301,710,879,1890,15.925925925925927,37.56613756613756,46.507936507936506
2016-02-01,423,738,1547,2708,15.620384047267354,27.252584933530283,57.12703101920237
2016-02-02,957,835,1808,3600,26.583333333333332,23.194444444444446,50.22222222222222
2016-02-03,354,926,1358,2638,13.419257012888552,35.10235026535254,51.4783927217589
2016-02-04,318,709,1177,2204,14.42831215970962,32.16878402903811,53.402903811252266
2016-02-05,521,561,1252,2334,22.322193658954586,24.03598971722365,53.64181662382177
2016-02-06,514,392,875,1781,28.860190903986528,22.01010668163953,49.12970241437395
2016-02-07,407,322,720,1449,28.08833678398896,22.22222222222222,49.68944099378882
2016-02-08,395,414,1360,2169,18.211157215306592,19.08713692946058,62.701705855232824
2016-02-09,724,490,1277,2491,29.0646326776395,19.67081493376154,51.26455238859896
2016-02-10,359,515,1168,2042,17.580803134182172,25.220372184133204,57.19882468168463
2016-02-11,480,442,1015,1937,24.780588538977803,22.818791946308725,52.400619514713476
2016-02-12,361,385,1062,1808,19.966814159292035,21.294247787610622,58.73893805309734
2016-02-13,401,379,967,1747,22.953634802518604,21.694333142530052,55.35203205495135
2016-02-14,337,438,1159,1934,17.425025853154086,22.64736297828335,59.927611168562564
2016-02-15,400,498,885,1783,22.434099831744252,27.930454290521595,49.635445877734156
2016-02-16,371,600,1148,2119,17.50825861255309,28.31524303916942,54.17649834827749
2016-02-17,319,537,1258,2114,15.089877010406813,25.402081362346262,59.508041627246925
2016-02-18,117,197,477,791,14.791403286978507,24.905183312262956,60.30341340075853
2016-02-19,253,553,1079,1885,13.421750663129972,29.336870026525197,57.24137931034483
2016-02-20,192,435,804,1431,13.417190775681343,30.398322851153043,56.18448637316562
2016-02-21,175,339,733,1247,14.033680834001604,27.18524458700882,58.781074578989575
2016-02-22,279,465,981,1725,16.17391304347826,26.956521739130434,56.869565217391305
2016-02-23,442,595,1477,2514,17.58154335719968,23.667462211614957,58.75099443118537
2016-02-24,410,593,1044,2047,20.029311187103076,28.96922325354177,51.001465559355154
2016-02-25,353,680,1013,2046,17.253176930596286,33.235581622678396,49.51124144672532
2016-02-26,384,589,1035,2008,19.12350597609562,29.332669322709165,51.54382470119522
2016-02-27,213,476,813,1502,14.181091877496671,31.69107856191744,54.12782956058588
2016-02-28,297,594,824,1715,17.31778425655977,34.63556851311954,48.0466472303207
2016-02-29,957,2339,2923,6219,15.38832609744332,37.61054831966554,47.00112558289114
2016-03-01,456,741,1384,2581,17.66757070902751,28.709802402169704,53.62262688880279
2016-03-02,399,717,1158,2274,17.54617414248021,31.53034300791557,50.92348284960422
2016-03-03,499,847,1244,2590,19.266409266409266,32.7027027027027,48.03088803088803
2016-03-04,426,578,1417,2421,17.59603469640644,23.874432052870713,58.52953325072284
2016-03-05,416,364,780,1560,26.666666666666668,23.333333333333332,50.0
2016-03-06,301,389,740,1430,21.048951048951047,27.202797202797203,51.74825174825175
2016-03-07,376,566,1171,2113,17.794604827259818,26.786559394226217,55.418835778513966
2016-03-08,455,655,1184,2294,19.83435047951177,28.55274629468178,51.61290322580645
2016-03-09,793,924,1678,3395,23.357879234167893,27.216494845360824,49.42562592047128
2016-03-10,1095,858,1460,3413,32.083211251098746,25.13917374743627,42.77761500146499
2016-03-11,582,648,1302,2532,22.985781990521325,25.59241706161137,51.421800947867304
2016-03-12,270,379,812,1461,18.480492813141684,25.94113620807666,55.578370978781656
2016-03-13,288,333,733,1354,21.270310192023633,24.593796159527326,54.13589364844904
2016-03-14,710,740,1261,2711,26.189597934341574,27.29620066396164,46.514201401696795
2016-03-15,412,575,1131,2118,19.452313503305003,27.148253068932952,53.39943342776204
2016-03-16,414,1105,1391,2910,14.22680412371134,37.97250859106529,47.80068728522337
2016-03-17,381,827,1076,2284,16.68126094570928,36.20840630472855,47.110332749562176
2016-03-18,364,681,1166,2211,16.463138851198554,30.800542740841248,52.736318407960205
2016-03-19,268,510,1200,1978,13.549039433771487,25.783619817997977,60.66734074823054
2016-03-20,285,587,961,1833,15.548281505728315,32.0240043644299,52.42771412984178
2016-03-21,786,1041,1293,3120,25.192307692307693,33.36538461538461,41.44230769230769
2016-03-22,706,795,1751,3252,21.709717097170973,24.44649446494465,53.84378843788438
2016-03-23,802,613,1303,2718,29.506990434142754,22.553348050036792,47.93966151582046
2016-03-24,564,457,1029,2050,27.512195121951223,22.29268292682927,50.19512195121951
2016-03-25,427,396,917,1740,24.54022988505747,22.758620689655174,52.701149425287355
2016-03-26,337,329,751,1417,23.782639378969655,23.218066337332395,52.99929428369795
2016-03-27,341,492,780,1613,21.140731556106633,30.502169869807812,48.357098574085555
2016-03-28,432,389,934,1755,24.615384615384617,22.165242165242166,53.219373219373225
2016-03-29,508,714,836,2058,24.68415937803693,34.69387755102041,40.62196307094266
2016-03-30,464,637,1732,2833,16.37839745852453,22.484998235086483,61.13660430638899
2016-03-31,350,508,1100,1958,17.87538304392237,25.944841675178754,56.17977528089888
2016-04-01,260,556,937,1753,14.831717056474613,31.717056474614946,53.45122646891044
2016-04-02,267,477,888,1632,16.360294117647058,29.22794117647059,54.41176470588235
2016-04-03,269,537,907,1713,15.703444249854057,31.34851138353765,52.94804436660829
2016-04-04,865,731,1744,3340,25.898203592814372,21.88622754491018,52.215568862275454
2016-04-05,994,760,1795,3549,28.007889546351084,21.414482952944493,50.57762750070442
2016-04-06,440,512,1175,2127,20.68641278796427,24.07146215326751,55.242125058768224
2016-04-07,816,480,1076,2372,34.40134907251265,20.236087689713322,45.362563237774026
2016-04-08,1123,616,1670,3409,32.94221179231446,18.069815195071868,48.987973012613665
2016-04-09,630,744,2485,3859,16.325472920445712,19.279606115573984,64.39492096398031
2016-04-10,394,436,1328,2158,18.257645968489342,20.203892493049118,61.53846153846154
2016-04-11,349,472,1380,2201,15.856428895956384,21.444797819173104,62.69877328487051
2016-04-12,317,624,1259,2200,14.40909090909091,28.363636363636363,57.22727272727273
2016-04-13,316,525,1298,2139,14.773258532024311,24.544179523141654,60.682561944834035
2016-04-14,401,631,1355,2387,16.79932970255551,26.434855467113533,56.76581483033096
2016-04-15,614,782,1540,2936,20.91280653950954,26.634877384196187,52.45231607629428
2016-04-16,426,494,1049,1969,21.635347892331133,25.088877602844086,53.27577450482478
2016-04-17,333,441,1032,1806,18.438538205980066,24.418604651162788,57.14285714285714
2016-04-18,371,609,1231,2211,16.779737675260066,27.54409769335143,55.67616463138852
2016-04-19,408,728,1450,2586,15.777262180974477,28.151585460170146,56.07115235885538
2016-04-20,572,812,1712,3096,18.47545219638243,26.22739018087855,55.297157622739014
2016-04-21,491,1047,1577,3115,15.762439807383627,33.6115569823435,50.62600321027288
2016-04-22,751,1297,2040,4088,18.370841487279844,31.727005870841484,49.902152641878665
2016-04-23,621,538,1273,2432,25.53453947368421,22.121710526315788,52.34375
2016-04-24,519,467,969,1955,26.547314578005114,23.88746803069054,49.56521739130435
2016-04-25,647,712,1114,2473,26.162555600485245,28.79094217549535,45.046502224019406
2016-04-26,643,617,1524,2784,23.09626436781609,22.16235632183908,54.741379310344826
2016-04-27,615,565,1216,2396,25.6677796327212,23.580968280467445,50.75125208681135
2016-04-28,376,494,1253,2123,17.710786622703722,23.268959020254357,59.02025435704192
2016-04-29,313,427,1075,1815,17.245179063360883,23.52617079889807,59.22865013774105
2016-04-30,231,351,750,1332,17.34234234234234,26.351351351351347,56.30630630630631
2016-05-01,208,341,725,1274,16.3265306122449,26.766091051805336,56.907378335949765
2016-05-02,363,446,1039,1848,19.642857142857142,24.134199134199132,56.22294372294372
2016-05-03,619,540,1285,2444,25.327332242225857,22.0949263502455,52.57774140752864
2016-05-04,881,771,1345,2997,29.39606272939606,25.725725725725724,44.87821154487821
2016-05-05,550,696,1252,2498,22.017614091273018,27.862289831865496,50.120096076861486
2016-05-06,324,590,1031,1945,16.65809768637532,30.334190231362467,53.007712082262216
2016-05-07,325,387,735,1447,22.460262612301314,26.74498963372495,50.79474775397374
2016-05-08,228,336,755,1319,17.28582259287339,25.473843821076574,57.24033358605004
2016-05-09,371,460,1031,1862,19.924812030075188,24.704618689581096,55.370569280343716
2016-05-10,637,1038,1689,3364,18.935790725326992,30.85612366230678,50.208085612366226
2016-05-11,533,1043,2423,3999,13.328332083020754,26.081520380095025,60.59014753688422
2016-05-12,557,631,1883,3071,18.13741452295669,20.54705307717356,61.31553239986975
2016-05-13,333,456,1034,1823,18.266593527153045,25.01371365880417,56.71969281404279
2016-05-14,236,411,1205,1852,12.742980561555076,22.19222462203024,65.06479481641469
2016-05-15,392,774,1216,2382,16.456759026028546,32.49370277078086,51.04953820319059
2016-05-16,571,721,1384,2676,21.337817638266067,26.943198804185354,51.71898355754858
2016-05-17,505,507,1618,2630,19.20152091254753,19.277566539923953,61.52091254752852
2016-05-18,620,621,1579,2820,21.98581560283688,22.02127659574468,55.99290780141843
2016-05-19,327,547,1252,2126,15.380997177798683,25.72906867356538,58.88993414863594
2016-05-20,306,595,1248,2149,14.239181014425315,27.68729641693811,58.07352256863657
2016-05-21,221,510,943,1674,13.201911589008365,30.46594982078853,56.33213859020311
2016-05-22,213,352,776,1341,15.883668903803134,26.249067859806114,57.867263236390755
2016-05-23,413,501,1390,2304,17.92534722222222,21.744791666666664,60.329861111111114
2016-05-24,387,535,1620,2542,15.224232887490166,21.04642014162077,63.72934697088907
2016-05-25,517,560,1126,2203,23.467998184294146,25.419881979119385,51.11211983658648
2016-05-26,356,469,1528,2353,15.129621759456013,19.932001699957503,64.93837654058649
2016-05-27,372,677,1653,2702,13.76757957068838,25.055514433752773,61.17690599555885
2016-05-28,232,456,958,1646,14.094775212636696,27.703523693803163,58.201701093560146
2016-05-29,238,414,817,1469,16.20149761742682,28.182437031994557,55.61606535057862
2016-05-30,261,634,924,1819,14.348543155579991,34.8543155579989,50.79714128642111
2016-05-31,313,1061,1331,2705,11.571164510166358,39.22365988909427,49.20517560073937
2016-06-01,337,474,1380,2191,15.381104518484708,21.633957097215884,62.984938384299404
2016-06-02,447,592,1359,2398,18.64053377814846,24.68723936613845,56.67222685571309
2016-06-03,386,485,1239,2110,18.29383886255924,22.985781990521325,58.720379146919434
2016-06-04,281,362,899,1542,18.2230869001297,23.476005188067443,58.30090791180286
2016-06-05,337,524,957,1818,18.536853685368538,28.822882288228826,52.64026402640264
2016-06-06,323,526,986,1835,17.60217983651226,28.664850136239785,53.73297002724796
2016-06-07,260,814,947,2021,12.864918357248886,40.27709054923305,46.85799109351806
2016-06-08,240,601,1039,1880,12.76595744680851,31.968085106382976,55.265957446808514
2016-06-09,245,742,1078,2065,11.864406779661017,35.932203389830505,52.20338983050847
2016-06-10,265,586,1295,2146,12.348555452003728,27.306616961789377,60.3448275862069
2016-06-11,253,440,759,1452,17.424242424242426,30.303030303030305,52.27272727272727
2016-06-12,234,509,838,1581,14.800759013282732,32.19481340923466,53.0044275774826
2016-06-13,236,562,1276,2074,11.378977820636452,27.09739633558341,61.52362584378014
2016-06-14,274,443,1340,2057,13.32036947010209,21.536217792902285,65.14341273699561
2016-06-15,260,413,981,1654,15.719467956469165,24.96977025392987,59.31076178960096
2016-06-16,275,557,1032,1864,14.753218884120173,29.88197424892704,55.36480686695279
2016-06-17,266,531,1029,1826,14.56736035049288,29.07995618838992,56.352683461117195
2016-06-18,229,381,629,1239,18.48264729620662,30.750605326876514,50.76674737691687
2016-06-19,240,357,711,1308,18.34862385321101,27.293577981651374,54.357798165137616
2016-06-20,312,502,1007,1821,17.1334431630972,27.56727073036793,55.29928610653487
2016-06-21,236,1218,1060,2514,9.387430389817025,48.44868735083532,42.16388225934765
2016-06-22,245,527,896,1668,14.688249400479616,31.594724220623498,53.71702637889688
2016-06-23,577,505,1091,2173,26.55315232397607,23.239760699493786,50.20708697653015
2016-06-24,468,451,1110,2029,23.06554953178906,22.227698373583046,54.706752094627895
2016-06-25,433,329,646,1408,30.75284090909091,23.366477272727273,45.88068181818182
2016-06-26,188,336,582,1106,16.998191681735985,30.37974683544304,52.62206148282098
2016-06-27,335,368,1015,1718,19.49941792782305,21.42025611175786,59.08032596041909
2016-06-28,273,416,1330,2019,13.521545319465082,20.60425953442298,65.87419514611193
2016-06-29,425,739,1210,2374,17.902274641954506,31.128896377422073,50.968828980623414
2016-06-30,402,890,1423,2715,14.806629834254142,32.78084714548803,52.41252302025783
2016-07-01,417,637,1159,2213,18.84319927699955,28.78445549028468,52.372345232715766
2016-07-02,204,339,780,1323,15.419501133786847,25.623582766439913,58.95691609977324
2016-07-03,233,566,769,1568,14.85969387755102,36.0969387755102,49.04336734693878
2016-07-04,211,427,747,1385,15.234657039711191,30.830324909747294,53.935018050541515
2016-07-05,230,490,875,1595,14.420062695924765,30.721003134796238,54.858934169278996
2016-07-06,270,531,809,1610,16.77018633540373,32.98136645962733,50.24844720496895
2016-07-07,230,690,875,1795,12.813370473537605,38.440111420612816,48.74651810584958
2016-07-08,194,378,995,1567,12.380344607530311,24.122527121888957,63.497128270580724
2016-07-09,151,389,657,1197,12.614870509607352,32.49791144527986,54.88721804511278
2016-07-10,165,359,631,1155,14.285714285714285,31.082251082251084,54.63203463203463
2016-07-11,212,418,839,1469,14.431586113002043,28.454731109598363,57.11368277739959
2016-07-12,354,518,1232,2104,16.82509505703422,24.61977186311787,58.55513307984791
2016-07-13,320,368,920,1608,19.900497512437813,22.885572139303484,57.2139303482587
2016-07-14,380,418,829,1627,23.35586969883221,25.69145666871543,50.95267363245236
2016-07-15,312,497,1050,1859,16.783216783216783,26.73480365788058,56.48197955890264
2016-07-16,251,294,823,1368,18.34795321637427,21.49122807017544,60.16081871345029
2016-07-17,227,283,701,1211,18.74483897605285,23.36911643270025,57.8860445912469
2016-07-18,355,436,882,1673,21.219366407650927,26.060968320382543,52.719665271966534
2016-07-19,444,798,1161,2403,18.476903870162296,33.20848938826467,48.31460674157304
2016-07-20,367,782,1413,2562,14.324746291959405,30.52302888368462,55.15222482435597
2016-07-21,687,628,1458,2773,24.774612333213128,22.646952758745044,52.57843490804183
2016-07-22,485,605,1607,2697,17.982944011865033,22.432332220986282,59.58472376714868
2016-07-23,275,413,864,1552,17.719072164948454,26.61082474226804,55.670103092783506
2016-07-24,308,457,903,1668,18.465227817745802,27.398081534772185,54.13669064748201
2016-07-25,312,521,1139,1972,15.821501014198782,26.41987829614604,57.758620689655174
2016-07-26,373,616,1239,2228,16.741472172351884,27.648114901256733,55.61041292639138
2016-07-27,372,736,1259,2367,15.716096324461343,31.09421208280524,53.18969159273341
2016-07-28,424,899,1599,2922,14.510609171800137,30.76659822039699,54.72279260780287
2016-07-29,357,592,1374,2323,15.368058544984933,25.484287559190697,59.14765389582437
2016-07-30,280,324,988,1592,17.587939698492463,20.35175879396985,62.06030150753769
2016-07-31,160,329,748,1237,12.934518997574779,26.596604688763136,60.46887631366209
2016-08-01,532,429,1178,2139,24.87143525011688,20.05610098176718,55.072463768115945
2016-08-02,252,467,991,1710,14.736842105263156,27.309941520467834,57.953216374269005
2016-08-03,320,532,1053,1905,16.79790026246719,27.926509186351705,55.2755905511811
2016-08-04,343,429,1053,1825,18.794520547945208,23.506849315068493,57.69863013698631
2016-08-05,759,381,1095,2235,33.95973154362416,17.04697986577181,48.99328859060403
2016-08-06,1591,2234,3306,7131,22.311036320291684,31.328004487449167,46.36095919225915
2016-08-07,337,331,752,1420,23.73239436619718,23.309859154929576,52.95774647887323
2016-08-08,388,454,1149,1991,19.487694625816175,22.802611752887998,57.709693621295834
2016-08-09,317,450,1122,1889,16.781365802011646,23.82212811011117,59.396506087877185
2016-08-10,324,653,958,1935,16.74418604651163,33.746770025839794,49.50904392764858
2016-08-11,296,748,1083,2127,13.91631405735778,35.166901739539256,50.916784203102964
2016-08-12,426,548,1276,2250,18.933333333333334,24.355555555555554,56.71111111111111
2016-08-13,315,398,1091,1804,17.46119733924612,22.06208425720621,60.47671840354767
2016-08-14,258,444,943,1645,15.683890577507597,26.990881458966566,57.32522796352584
2016-08-15,316,587,1732,2635,11.992409867172675,22.277039848197344,65.73055028462998
2016-08-16,480,730,1831,3041,15.784281486353175,24.005261427162118,60.210457086484716
2016-08-17,495,713,1622,2830,17.491166077738516,25.19434628975265,57.314487632508836
2016-08-18,461,945,2336,3742,12.319615179048638,25.253874933190808,62.42650988776055
2016-08-19,799,712,1264,2775,28.792792792792792,25.657657657657655,45.54954954954955
2016-08-20,404,417,852,1673,24.148236700537957,24.92528392109982,50.926479378362224
2016-08-21,347,451,892,1690,20.532544378698226,26.68639053254438,52.781065088757394
2016-08-22,593,462,1001,2056,28.842412451361866,22.47081712062257,48.68677042801556
2016-08-23,559,570,1401,2530,22.09486166007905,22.529644268774703,55.37549407114625
2016-08-24,365,590,1666,2621,13.925982449446774,22.510492178557804,63.563525371995425
2016-08-25,282,795,1339,2416,11.672185430463577,32.90562913907284,55.42218543046358
2016-08-26,259,479,974,1712,15.128504672897197,27.97897196261682,56.89252336448598
2016-08-27,252,359,743,1354,18.61152141802068,26.514032496307237,54.874446085672076
2016-08-28,286,322,739,1347,21.232368225686713,23.90497401633259,54.86265775798069
2016-08-29,270,370,840,1480,18.243243243243242,25.0,56.75675675675676
2016-08-30,315,413,768,1496,21.056149732620323,27.606951871657753,51.33689839572193
2016-08-31,284,469,949,1702,16.686251468860164,27.555816686251468,55.75793184488836
2016-09-01,411,566,1329,2306,17.82307025151778,24.544666088464876,57.632263660017344
2016-09-02,252,440,1523,2215,11.376975169300225,19.864559819413092,68.75846501128669
2016-09-03,431,865,4526,5822,7.402954311233254,14.857437306767435,77.73960838199932
2016-09-04,367,723,2718,3808,9.637605042016807,18.986344537815125,71.37605042016807
2016-09-05,400,685,1492,2577,15.521924718665115,26.581296080714008,57.89677920062088
2016-09-06,644,853,1527,3024,21.296296296296298,28.20767195767196,50.49603174603175
2016-09-07,387,492,1352,2231,17.34648139847602,22.052891080233078,60.6006275212909
2016-09-08,409,462,1102,1973,20.729853015712113,23.41611758743031,55.85402939685758
2016-09-09,341,504,1057,1902,17.928496319663513,26.498422712933756,55.57308096740273
2016-09-10,452,345,1172,1969,22.955815134586086,17.521584560690705,59.522600304723206
2016-09-11,338,462,1402,2202,15.349682107175294,20.98092643051771,63.66939146230699
2016-09-12,341,502,1053,1896,17.985232067510548,26.476793248945146,55.5379746835443
2016-09-13,416,727,1326,2469,16.848926690968003,29.445119481571485,53.705953827460505
2016-09-14,486,638,1170,2294,21.18570183086312,27.811682650392328,51.002615518744555
2016-09-15,415,611,1316,2342,17.719897523484203,26.088812980358668,56.191289496157125
2016-09-16,360,568,1069,1997,18.02704056084126,28.44266399599399,53.530295443164746
2016-09-17,207,373,951,1531,13.520574787720443,24.363161332462443,62.11626387981711
2016-09-18,536,362,1030,1928,27.800829875518673,18.775933609958507,53.42323651452282
2016-09-19,326,492,965,1783,18.283791362871565,27.59394279304543,54.122265844083
2016-09-20,448,530,1450,2428,18.451400329489292,21.828665568369026,59.71993410214168
2016-09-21,555,592,1353,2500,22.2,23.68,54.120000000000005
2016-09-22,419,682,1402,2503,16.73991210547343,27.24730323611666,56.012784658409906
2016-09-23,369,506,1008,1883,19.596388741370156,26.872012745618694,53.53159851301115
2016-09-24,311,374,750,1435,21.67247386759582,26.062717770034844,52.264808362369344
2016-09-25,292,469,937,1698,17.196702002355714,27.62073027090695,55.18256772673734
2016-09-26,343,832,1487,2662,12.88504883546206,31.254695717505637,55.8602554470323
2016-09-27,1458,2893,6655,11006,13.247319643830638,26.285662365982194,60.467017990187166
2016-09-28,434,694,1326,2454,17.685411572942137,28.280358598207012,54.034229828850854
2016-09-29,538,714,1164,2416,22.2682119205298,29.55298013245033,48.17880794701987
2016-09-30,451,509,1051,2011,22.42665340626554,25.310790651417204,52.262555942317256
2016-10-01,19,29,36,84,22.61904761904762,34.523809523809526,42.857142857142854
