Date,Negative,Positive,Neutral,Total,Percentage_neg,Percentage_pos,Percentage_neutr
2019-10-01,1195,2014,2204,5413,22.07648254202845,37.20672455200443,40.71679290596711
2019-10-02,1142,1843,2187,5172,22.08043310131477,35.63418406805878,42.28538283062645
2019-10-03,1255,1752,1877,4884,25.696150696150692,35.872235872235876,38.43161343161343
2019-10-04,1188,1715,1699,4602,25.814863102998697,37.26640591047371,36.9187309865276
2019-10-05,865,1201,1369,3435,25.181950509461426,34.96360989810772,39.85443959243086
2019-10-06,719,1087,1413,3219,22.336129232680957,33.76825100963032,43.89561975768873
2019-10-07,1048,1546,1628,4222,24.82235907153008,36.61771672193274,38.55992420653719
2019-10-08,1112,1722,1742,4576,24.3006993006993,37.63111888111888,38.06818181818182
2019-10-09,965,1569,1561,4095,23.565323565323563,38.31501831501832,38.11965811965812
2019-10-10,999,1722,1652,4373,22.844729018980107,39.3780013720558,37.7772696089641
2019-10-11,1062,1642,1708,4412,24.070716228467816,37.216681776971896,38.712601994560295
2019-10-12,896,1253,1424,3573,25.07696613490064,35.06856982927512,39.854464035824236
2019-10-13,211,350,382,943,22.375397667020145,37.11558854718982,40.50901378579003
2019-10-14,802,1195,1303,3300,24.303030303030305,36.21212121212121,39.484848484848484
2019-10-15,830,1301,1278,3409,24.34731592842476,38.1636843649164,37.488999706658845
2019-10-16,915,1452,1440,3807,24.034672970843186,38.14026792750197,37.825059101654844
2019-10-17,1004,1450,1318,3772,26.617179215270415,38.44114528101803,34.94167550371156
2019-10-18,827,1321,1136,3284,25.182704019488426,40.225334957369064,34.59196102314251
2019-10-19,613,964,998,2575,23.805825242718445,37.4368932038835,38.75728155339806
2019-10-20,565,984,885,2434,23.212818405916188,40.427280197206244,36.35990139687757
2019-10-21,660,1113,1015,2788,23.672883787661405,39.92109038737446,36.40602582496413
2019-10-22,708,1213,1215,3136,22.5765306122449,38.67984693877551,38.74362244897959
2019-10-23,684,1181,1185,3050,22.42622950819672,38.721311475409834,38.85245901639344
2019-10-24,748,1204,1306,3258,22.958870472682626,36.95518723143032,40.085942295887044
2019-10-25,818,1240,1502,3560,22.97752808988764,34.831460674157306,42.19101123595506
2019-10-26,669,1003,1017,2689,24.879137225734475,37.300111565637785,37.82075120862775
2019-10-27,615,923,1059,2597,23.68117058144012,35.541008856372734,40.77782056218714
2019-10-28,781,1153,1209,3143,24.848870505886094,36.68469615017499,38.46643334393891
2019-10-29,894,1223,1214,3331,26.838787151005704,36.715700990693485,36.44551185830081
2019-10-30,1134,1628,1667,4429,25.603973808986225,36.75773312260104,37.63829306841273
2019-10-31,1113,1405,1534,4052,27.467917077986183,34.67423494570582,37.857847976307994
2019-11-01,849,1178,1306,3333,25.472547254725477,35.34353435343534,39.183918391839185
2019-11-02,693,944,1087,2724,25.440528634361232,34.65491923641703,39.904552129221734
2019-11-03,713,1019,933,2665,26.75422138836773,38.23639774859287,35.009380863039404
2019-11-04,910,1398,1527,3835,23.728813559322035,36.45371577574967,39.81747066492829
2019-11-05,1121,1641,2262,5024,22.312898089171977,32.663216560509554,45.02388535031847
2019-11-06,977,1534,1904,4415,22.129105322763305,34.74518686296716,43.12570781426954
2019-11-07,929,1436,1553,3918,23.711077080142932,36.651352730985195,39.63757018887188
2019-11-08,1014,1420,1467,3901,25.993335042296845,36.40092284029736,37.605742117405796
2019-11-09,1001,1227,1322,3550,28.197183098591548,34.563380281690144,37.239436619718305
2019-11-10,977,1256,1393,3626,26.94429123000552,34.63872035300607,38.41698841698842
2019-11-11,1102,1431,1587,4120,26.74757281553398,34.73300970873787,38.519417475728154
2019-11-12,1318,1596,1934,4848,27.186468646864686,32.92079207920792,39.89273927392739
2019-11-13,1219,1598,1981,4798,25.406419341392244,33.30554397665694,41.288036681950814
2019-11-14,1072,1406,1647,4125,25.98787878787879,34.084848484848486,39.92727272727273
2019-11-15,850,1191,1403,3444,24.680603948896632,34.58188153310105,40.73751451800232
2019-11-16,634,931,986,2551,24.85299882399059,36.49549196393571,38.6515092120737
2019-11-17,659,945,1094,2698,24.425500370644922,35.02594514455152,40.54855448480355
2019-11-18,796,1205,1258,3259,24.42467014421602,36.97453206505063,38.60079779073335
2019-11-19,824,1214,1412,3450,23.884057971014492,35.18840579710145,40.92753623188406
2019-11-20,764,1252,1350,3366,22.69756387403446,37.19548425430778,40.106951871657756
2019-11-21,883,1383,1479,3745,23.578104138851803,36.92923898531375,39.49265687583445
2019-11-22,684,1073,1139,2896,23.61878453038674,37.05110497237569,39.33011049723757
2019-11-23,694,942,1053,2689,25.808850873930826,35.031610264038676,39.159538862030494
2019-11-24,695,1033,1094,2822,24.627923458540042,36.60524450744153,38.76683203401843
2019-11-25,818,1152,1163,3133,26.109160548994577,36.76986913501437,37.120970315991066
2019-11-26,1099,1516,1479,4094,26.84416218856864,37.02979970688813,36.126038104543234
2019-11-27,1002,1385,1727,4114,24.355858045697616,33.66553232863394,41.97860962566845
2019-11-28,1074,1470,1882,4426,24.265702666064165,33.21283325802079,42.52146407591505
2019-11-29,934,1481,1878,4293,21.756347542511065,34.49802003261123,43.745632424877705
2019-11-30,749,1066,1357,3172,23.612862547288778,33.60655737704918,42.780580075662044
2019-12-01,873,1214,1423,3510,24.871794871794872,34.58689458689459,40.541310541310544
2019-12-02,1019,1725,1758,4502,22.634384717903156,38.316303864948914,39.04931141714793
2019-12-03,1122,1806,1777,4705,23.846971307120086,38.384697130712006,37.76833156216791
2019-12-04,1160,1927,1696,4783,24.25256115408739,40.28852184821242,35.45891699770019
2019-12-05,1044,1960,1669,4673,22.341108495613096,41.94307725230045,35.71581425208645
2019-12-06,902,1709,1466,4077,22.12411086583272,41.91807701741477,35.957812116752514
2019-12-07,841,1485,1358,3684,22.82844733984799,40.30944625407166,36.86210640608035
2019-12-08,720,1233,1221,3174,22.68431001890359,38.8468809073724,38.46880907372401
2019-12-09,1287,1610,1461,4358,29.53189536484626,36.94355208811381,33.524552547039924
2019-12-10,1294,1719,1441,4454,29.052537045352494,38.59452177817692,32.35294117647059
2019-12-11,1399,2589,1741,5729,24.41961947983941,45.19113283295514,30.389247687205444
2019-12-12,1470,2247,1834,5551,26.48171500630517,40.47919293820933,33.0390920554855
2019-12-13,1105,1688,1559,4352,25.390625,38.786764705882355,35.822610294117645
2019-12-14,960,1410,1208,3578,26.830631637786475,39.407490217998884,33.76187814421465
2019-12-15,1107,1298,1396,3801,29.123914759273877,34.148908182057355,36.72717705866877
2019-12-16,1047,1330,1508,3885,26.94980694980695,34.234234234234236,38.815958815958815
2019-12-17,820,1230,1225,3275,25.0381679389313,37.55725190839695,37.404580152671755
2019-12-18,828,1118,1279,3225,25.674418604651162,34.66666666666667,39.65891472868217
2019-12-19,865,1215,1326,3406,25.396359365825017,35.672342924251325,38.93129770992366
2019-12-20,795,1242,1335,3372,23.576512455516013,36.83274021352313,39.59074733096085
2019-12-21,701,1016,1017,2734,25.640087783467447,37.16166788588149,37.19824433065106
2019-12-22,792,1076,1047,2915,27.169811320754718,36.912521440823326,35.917667238421956
2019-12-23,816,1215,1228,3259,25.038355323718932,37.281374654802086,37.680270021478975
2019-12-24,736,1158,1177,3071,23.9661348095083,37.70758710517747,38.32627808531423
2019-12-25,543,965,1030,2538,21.39479905437352,38.0220646178093,40.58313632781718
2019-12-26,775,1285,1254,3314,23.385636692818345,38.7748943874472,37.83946891973446
2019-12-27,782,1269,1221,3272,23.899755501222494,38.78361858190709,37.316625916870414
2019-12-28,810,1234,1144,3188,25.407779171894607,38.707653701380174,35.88456712672522
2019-12-29,933,1249,1289,3471,26.879861711322384,35.983866320944976,37.13627196773264
2019-12-30,1116,1522,1443,4081,27.346238666993383,37.294780691007105,35.35898064199951
2019-12-31,1120,1453,1447,4020,27.860696517412936,36.14427860696517,35.99502487562189
2020-01-01,950,1345,1249,3544,26.8058690744921,37.95146726862303,35.24266365688488
2020-01-02,1401,1833,2014,5248,26.695884146341463,34.927591463414636,38.3765243902439
2020-01-03,1583,1958,2240,5781,27.382805742951042,33.869572738280574,38.747621518768376
2020-01-04,235,301,283,819,28.69352869352869,36.75213675213676,34.55433455433455
2020-01-05,1542,2128,1803,5473,28.174675680613927,38.881783299835554,32.94354101955052
2020-01-06,1536,2127,1887,5550,27.675675675675677,38.32432432432433,34.0
2020-01-07,1667,2173,2167,6007,27.75095721658066,36.17446312635259,36.07457965706676
2020-01-08,1318,1706,1791,4815,27.372793354101766,35.43094496365524,37.19626168224299
2020-01-09,1163,1657,1596,4416,26.336050724637683,37.522644927536234,36.141304347826086
2020-01-10,1146,2564,1988,5698,20.112320112320113,44.998244998245,34.88943488943489
2020-01-11,1498,2702,2479,6679,22.428507261566104,40.45515795777811,37.116334780655784
2020-01-12,1545,2554,2299,6398,24.148171303532354,39.91872460143795,35.93310409502969
2020-01-13,1508,2099,1925,5532,27.259580621836587,37.94287780187997,34.79754157628344
2020-01-14,1209,1792,1714,4715,25.641569459172853,38.006362672322375,36.352067868504776
2020-01-15,1647,2156,2064,5867,28.072268621101077,36.74791205045168,35.17981932844725
2020-01-16,2142,2040,2029,6211,34.487200128803735,32.84495250362261,32.66784736757366
2020-01-17,1080,1670,1619,4369,24.719615472648204,38.223849851224536,37.056534676127264
2020-01-18,958,1424,1421,3803,25.19063896923481,37.44412306074152,37.36523797002367
2020-01-19,928,1331,1509,3768,24.628450106157114,35.323779193205944,40.047770700636946
2020-01-20,987,1595,1579,4161,23.72025955299207,38.33213169911079,37.947608747897135
2020-01-21,1250,2120,1919,5289,23.633957269805254,40.08319152958971,36.28285120060503
2020-01-22,1243,2054,2070,5367,23.16005217067263,38.27091485000932,38.56903297931806
2020-01-23,1200,1943,1744,4887,24.554941682013506,39.7585430734602,35.6865152445263
2020-01-24,979,1656,1493,4128,23.71608527131783,40.116279069767444,36.167635658914726
2020-01-25,792,1138,1096,3026,26.17316589557171,37.60740251156642,36.21943159286186
2020-01-26,695,983,1041,2719,25.56086796616403,36.15299742552409,38.286134608311876
2020-01-27,719,1308,1203,3230,22.260061919504643,40.4953560371517,37.244582043343655
2020-01-28,752,1226,1175,3153,23.850301300348875,38.88360291785601,37.266095781795116
2020-01-29,669,1188,1094,2951,22.670281260589633,40.257539817011185,37.07217892239918
2020-01-30,763,1135,1141,3039,25.1069430733794,37.34781178019085,37.54524514642974
2020-01-31,726,1148,1078,2952,24.59349593495935,38.88888888888889,36.517615176151764
2020-02-01,604,1014,913,2531,23.864085341762152,40.06321612011063,36.07269853812723
2020-02-02,632,1209,1152,2993,21.11593718676913,40.39425325760107,38.4898095556298
2020-02-03,809,1417,1236,3462,23.367995378393992,40.93009820912768,35.70190641247834
2020-02-04,928,1481,1529,3938,23.56526155408837,37.60792280345353,38.8268156424581
2020-02-05,863,1432,1356,3651,23.637359627499315,39.22213092303479,37.140509449465895
2020-02-06,827,1260,1234,3321,24.902137910267992,37.94037940379404,37.15748268593797
2020-02-07,955,1402,1533,3890,24.55012853470437,36.041131105398456,39.40874035989717
2020-02-08,931,1293,1426,3650,25.506849315068493,35.42465753424657,39.06849315068493
2020-02-09,792,1103,1107,3002,26.382411725516324,36.742171885409725,36.87541638907395
2020-02-10,773,1353,1265,3391,22.795635505750518,39.89973459156591,37.30462990268357
2020-02-11,891,1530,1397,3818,23.336825563122055,40.073336825563125,36.58983761131482
2020-02-12,777,1340,1275,3392,22.90683962264151,39.50471698113208,37.58844339622642
2020-02-13,912,1550,1387,3849,23.694466095089634,40.270200051961545,36.03533385294882
2020-02-14,811,1328,1384,3523,23.02015327845586,37.695146182231056,39.284700539313086
2020-02-15,625,1113,1053,2791,22.39340738086707,39.87817986384808,37.72841275528484
2020-02-16,749,1053,1161,2963,25.278434019574753,35.53830577117786,39.183260209247386
2020-02-17,775,1196,1057,3028,25.59445178335535,39.49801849405548,34.90752972258917
2020-02-18,861,1373,1321,3555,24.219409282700422,38.621659634317865,37.15893108298172
2020-02-19,854,1196,1299,3349,25.500149298298,35.71215288145715,38.78769782024485
2020-02-20,913,1430,1487,3830,23.838120104438644,37.33681462140992,38.82506527415144
2020-02-21,795,1138,1080,3013,26.38566213076668,37.769664785927645,35.84467308330568
2020-02-22,656,1006,959,2621,25.028615032430366,38.38229683326975,36.589088134299885
2020-02-23,691,1117,973,2781,24.84717727436174,40.165408126573176,34.98741459906508
2020-02-24,864,1501,1451,3816,22.641509433962266,39.33438155136268,38.02410901467505
2020-02-25,784,1328,1287,3399,23.06560753162695,39.07031479847014,37.86407766990291
2020-02-26,873,1312,1341,3526,24.758933635847985,37.2093023255814,38.03176403857062
2020-02-27,1012,1486,1393,3891,26.008738113595477,38.190696479054225,35.80056540735029
2020-02-28,1013,1545,1464,4022,25.18647439085032,38.413724515166585,36.39980109398309
2020-02-29,818,1184,1186,3188,25.65872020075282,37.13927227101631,37.202007528230865
2020-03-01,654,987,971,2612,25.038284839203673,37.78713629402756,37.17457886676876
2020-03-02,707,1256,1204,3167,22.32396589832649,39.658983264919485,38.017050836754024
2020-03-03,710,1336,1107,3153,22.51823660006343,42.37234379955598,35.10941960038059
2020-03-04,895,1270,1224,3389,26.408970197698434,37.47418117438773,36.11684862791384
2020-03-05,835,1348,1204,3387,24.653085326247417,39.79923235901978,35.5476823147328
2020-03-06,685,1124,1057,2866,23.900907187718072,39.218422889043964,36.88066992323796
2020-03-07,683,951,866,2500,27.32,38.04,34.64
2020-03-08,595,930,877,2402,24.771024146544544,38.71773522064946,36.51124063280599
2020-03-09,814,1270,1134,3218,25.295214418893725,39.465506525792414,35.23927905531386
2020-03-10,773,1437,1110,3320,23.283132530120483,43.28313253012048,33.433734939759034
2020-03-11,941,1579,1203,3723,25.27531560569433,42.412033306473276,32.31265108783239
2020-03-12,971,1481,1436,3888,24.97427983539095,38.09156378600823,36.934156378600825
2020-03-13,826,1303,1474,3603,22.92533999444907,36.164307521509855,40.91035248404108
2020-03-14,676,922,1123,2721,24.84380742374127,33.88460124954061,41.27159132671812
2020-03-15,616,976,937,2529,24.3574535389482,38.59232898378806,37.05021747726374
2020-03-16,883,1190,1225,3298,26.773802304426926,36.08247422680412,37.143723468768954
2020-03-17,833,1181,1215,3229,25.797460514091046,36.57479095695262,37.62774852895633
2020-03-18,1189,1176,1137,3502,33.95202741290691,33.58081096516277,32.46716162193032
2020-03-19,858,1080,1160,3098,27.695287282117498,34.86120077469335,37.44351194318916
2020-03-20,667,938,969,2574,25.91297591297591,36.44133644133644,37.645687645687644
2020-03-21,574,832,842,2248,25.533807829181494,37.01067615658363,37.455516014234874
2020-03-22,567,888,855,2310,24.545454545454547,38.44155844155844,37.01298701298701
2020-03-23,659,926,965,2550,25.84313725490196,36.31372549019608,37.84313725490196
2020-03-24,721,1122,1051,2894,24.91361437456807,38.76986869384934,36.31651693158258
2020-03-25,642,987,873,2502,25.65947242206235,39.4484412470024,34.89208633093525
2020-03-26,640,911,921,2472,25.88996763754045,36.85275080906149,37.25728155339806
2020-03-27,713,1015,917,2645,26.956521739130434,38.37429111531191,34.66918714555766
2020-03-28,522,899,766,2187,23.868312757201647,41.106538637402835,35.025148605395515
2020-03-29,520,795,768,2083,24.963994239078254,38.166106577052325,36.86989918386942
2020-03-30,545,783,788,2116,25.756143667296787,37.00378071833648,37.24007561436673
2020-03-31,712,1051,926,2689,26.478244700632203,39.085161770174786,34.43659352919301
2020-04-01,768,1168,990,2926,26.247436773752565,39.91797676008203,33.83458646616541
2020-04-02,700,967,940,2607,26.850786344457227,37.09244342155735,36.056770233985425
2020-04-03,596,886,910,2392,24.91638795986622,37.04013377926421,38.04347826086957
2020-04-04,499,772,752,2023,24.666337123084528,38.161146811665844,37.172516065249624
2020-04-05,536,732,726,1994,26.880641925777333,36.71013039117352,36.40922768304915
2020-04-06,447,794,707,1948,22.946611909650922,40.75975359342916,36.29363449691992
2020-04-07,473,806,683,1962,24.108053007135577,41.08053007135576,34.811416921508666
2020-04-08,559,901,811,2271,24.614707177454868,39.6741523557904,35.711140466754735
2020-04-09,652,1090,983,2725,23.926605504587155,40.0,36.07339449541284
2020-04-10,610,894,902,2406,25.353283458021615,37.1571072319202,37.489609310058185
2020-04-11,572,819,814,2205,25.94104308390023,37.142857142857146,36.91609977324263
2020-04-12,444,696,700,1840,24.130434782608695,37.826086956521735,38.04347826086957
2020-04-13,514,827,917,2258,22.763507528786537,36.62533215234721,40.611160318866254
2020-04-14,558,998,804,2360,23.64406779661017,42.28813559322034,34.067796610169495
2020-04-15,688,878,857,2423,28.3945522080066,36.23607098638052,35.36937680561288
2020-04-16,605,853,825,2283,26.500219010074467,37.36311870346036,36.136662286465175
2020-04-17,646,851,922,2419,26.705250103348494,35.17982637453493,38.11492352211658
2020-04-18,520,672,791,1983,26.22289460413515,33.88804841149773,39.88905698436712
2020-04-19,499,682,712,1893,26.36027469624934,36.027469624933964,37.612255678816695
2020-04-20,519,959,803,2281,22.753178430512932,42.04296361245068,35.20385795703639
2020-04-21,532,1031,820,2383,22.324800671422576,43.26479227864037,34.41040704993705
2020-04-22,1047,2304,1645,4996,20.956765412329865,46.11689351481185,32.926341072858285
2020-04-23,729,1265,1203,3197,22.802627463246793,39.568345323741006,37.6290272130122
2020-04-24,576,1014,1078,2668,21.58920539730135,38.005997001499246,40.4047976011994
2020-04-25,504,758,602,1864,27.038626609442062,40.66523605150215,32.29613733905579
2020-04-26,473,682,630,1785,26.498599439775912,38.207282913165265,35.294117647058826
2020-04-27,537,809,696,2042,26.29774730656219,39.618021547502444,34.084231145935355
2020-04-28,568,861,780,2209,25.712992304210047,38.97691263014939,35.31009506564056
2020-04-29,510,782,679,1971,25.8751902587519,39.67529173008625,34.44951801116184
2020-04-30,562,907,770,2239,25.1004912907548,40.50915587315766,34.39035283608754
2020-05-01,478,716,707,1901,25.144660704892164,37.66438716465018,37.19095213045765
2020-05-02,376,623,607,1606,23.41220423412204,38.7920298879203,37.79576587795766
2020-05-03,483,644,708,1835,26.321525885558582,35.095367847411445,38.58310626702997
2020-05-04,480,793,719,1992,24.096385542168676,39.80923694779116,36.09437751004016
2020-05-05,775,981,850,2606,29.739063699155793,37.6438986953185,32.61703760552571
2020-05-06,599,1062,891,2552,23.4717868338558,41.61442006269592,34.91379310344828
2020-05-07,622,1465,945,3032,20.514511873350923,48.3179419525066,31.16754617414248
2020-05-08,822,1368,992,3182,25.83280955373979,42.99182903834067,31.17536140791955
2020-05-09,865,1141,1642,3648,23.711622807017545,31.277412280701753,45.010964912280706
2020-05-10,765,2185,1177,4127,18.53646716743397,52.944027138357164,28.519505694208867
2020-05-11,530,1154,866,2550,20.784313725490197,45.254901960784316,33.96078431372549
2020-05-12,541,1353,856,2750,19.672727272727272,49.2,31.127272727272725
2020-05-13,619,1101,885,2605,23.761996161228407,42.26487523992322,33.97312859884837
2020-05-14,1073,1051,918,3042,35.27284681130835,34.54963839579224,30.17751479289941
2020-05-15,551,919,883,2353,23.41691457713557,39.05652358691033,37.526561835954105
2020-05-16,480,703,793,1976,24.291497975708502,35.57692307692308,40.131578947368425
2020-05-17,445,660,708,1813,24.544953116381688,36.40375068946498,39.05129619415334
2020-05-18,514,778,720,2012,25.54671968190855,38.66799204771372,35.785288270377734
2020-05-19,649,1070,949,2668,24.32533733133433,40.104947526236884,35.569715142428784
2020-05-20,615,1021,899,2535,24.2603550295858,40.27613412228797,35.463510848126234
2020-05-21,527,926,1013,2466,21.370640713706408,37.5506893755069,41.078669910786694
2020-05-22,479,752,741,1972,24.290060851926977,38.13387423935091,37.57606490872211
2020-05-23,446,663,661,1770,25.19774011299435,37.45762711864407,37.34463276836158
2020-05-24,440,663,707,1810,24.30939226519337,36.629834254143645,39.06077348066299
2020-05-25,467,720,738,1925,24.25974025974026,37.4025974025974,38.33766233766234
2020-05-26,530,816,796,2142,24.743230625583568,38.095238095238095,37.16153127917834
2020-05-27,546,800,850,2196,24.863387978142075,36.42987249544626,38.70673952641166
2020-05-28,514,854,722,2090,24.593301435406698,40.86124401913875,34.54545454545455
2020-05-29,458,919,726,2103,21.778411792677126,43.699476937708035,34.52211126961483
2020-05-30,417,625,583,1625,25.661538461538463,38.46153846153847,35.87692307692308
2020-05-31,605,546,572,1723,35.1131746952989,31.688914683691237,33.19791062100987
2020-06-01,495,715,659,1869,26.484751203852326,38.25575173889781,35.25949705724987
2020-06-02,493,719,676,1888,26.11228813559322,38.08262711864407,35.80508474576271
2020-06-03,598,743,661,2002,29.87012987012987,37.11288711288711,33.01698301698301
2020-06-04,551,786,787,2124,25.94161958568738,37.005649717514125,37.05273069679849
2020-06-05,761,1545,980,3286,23.15885575167377,47.017650639074866,29.82349360925137
2020-06-06,425,640,575,1640,25.914634146341463,39.02439024390244,35.0609756097561
2020-06-07,402,598,567,1567,25.654116145500954,38.1620931716656,36.18379068283344
2020-06-08,481,842,733,2056,23.394941634241246,40.95330739299611,35.65175097276265
2020-06-09,575,803,986,2364,24.323181049069373,33.967851099830796,41.70896785109983
2020-06-10,513,774,764,2051,25.012189176011702,37.73768893222818,37.25012189176012
2020-06-11,511,757,706,1974,25.886524822695034,38.34853090172239,35.76494427558257
2020-06-12,442,708,725,1875,23.57333333333333,37.76,38.666666666666664
2020-06-13,403,592,570,1565,25.750798722044728,37.82747603833866,36.42172523961661
2020-06-14,385,608,570,1563,24.632117722328857,38.89955214331414,36.46833013435701
2020-06-15,447,742,639,1828,24.452954048140043,40.59080962800875,34.9562363238512
2020-06-16,611,869,828,2308,26.473136915077987,37.65164644714038,35.875216637781634
2020-06-17,589,925,839,2353,25.031874203144923,39.311517212069695,35.65660858478538
2020-06-18,568,919,764,2251,25.233229675699686,40.8262994224789,33.94047090182141
2020-06-19,505,816,653,1974,25.58257345491388,41.33738601823708,33.08004052684904
2020-06-20,418,727,881,2026,20.63178677196446,35.88351431391905,43.484698914116485
2020-06-21,460,697,694,1851,24.851431658562937,37.65532144786602,37.49324689357104
2020-06-22,577,895,775,2247,25.67868268802848,39.83088562527815,34.49043168669337
2020-06-23,694,990,883,2567,27.035449941566032,38.566419945461625,34.39813011297234
2020-06-24,589,966,845,2400,24.541666666666668,40.25,35.208333333333336
2020-06-25,665,992,956,2613,25.449674703406046,37.96402602372751,36.586299272866434
2020-06-26,568,959,789,2316,24.52504317789292,41.40759930915372,34.067357512953365
2020-06-27,494,712,750,1956,25.255623721881392,36.400817995910025,38.34355828220859
2020-06-28,478,622,670,1770,27.005649717514125,35.14124293785311,37.85310734463277
2020-06-29,554,819,695,2068,26.789168278529978,39.60348162475822,33.6073500967118
2020-06-30,646,980,817,2443,26.4428980761359,40.114613180515754,33.44248874334834
2020-07-01,669,993,876,2538,26.35933806146572,39.125295508274235,34.515366430260045
2020-07-02,532,843,769,2144,24.813432835820894,39.31902985074627,35.867537313432834
2020-07-03,531,759,684,1974,26.899696048632222,38.44984802431611,34.650455927051674
2020-07-04,469,650,677,1796,26.11358574610245,36.191536748329625,37.69487750556793
2020-07-05,541,690,705,1936,27.944214876033058,35.64049586776859,36.41528925619835
2020-07-06,565,856,836,2257,25.033229951262737,37.92645104120514,37.040319007532126
2020-07-07,552,907,849,2308,23.91681109185442,39.29809358752166,36.78509532062392
2020-07-08,655,1002,903,2560,25.5859375,39.140625,35.2734375
2020-07-09,831,1104,1431,3366,24.688057040998217,32.79857397504456,42.513368983957214
2020-07-10,633,943,969,2545,24.87229862475442,37.05304518664047,38.07465618860511
2020-07-11,482,724,730,1936,24.89669421487603,37.39669421487603,37.70661157024794
2020-07-12,481,668,765,1914,25.130616509926856,34.90073145245559,39.96865203761755
2020-07-13,536,812,861,2209,24.264373019465822,36.75871435038479,38.97691263014939
2020-07-14,742,1022,903,2667,27.821522309711288,38.320209973753286,33.85826771653544
2020-07-15,817,1231,994,3042,26.85733070348455,40.46679815910585,32.6758711374096
2020-07-16,770,1131,959,2860,26.923076923076923,39.54545454545455,33.53146853146853
2020-07-17,632,951,827,2410,26.224066390041497,39.46058091286307,34.315352697095435
2020-07-18,518,726,712,1956,26.482617586912067,37.11656441717792,36.400817995910025
2020-07-19,499,727,743,1969,25.342813610970033,36.92229558151346,37.73489080751651
2020-07-20,718,853,836,2407,29.82966348151226,35.438304943913586,34.73203157457416
2020-07-21,696,876,752,2324,29.948364888123923,37.693631669535286,32.358003442340795
2020-07-22,593,1001,751,2345,25.28784648187633,42.68656716417911,32.02558635394456
2020-07-23,543,996,749,2288,23.732517482517483,43.53146853146853,32.73601398601399
2020-07-24,545,969,755,2269,24.019391802556193,42.706037902159544,33.27457029528426
2020-07-25,519,669,662,1850,28.054054054054056,36.16216216216216,35.78378378378378
2020-07-26,603,703,801,2107,28.618889416231607,33.36497389653536,38.01613668723303
2020-07-27,529,831,1216,2576,20.535714285714285,32.25931677018634,47.20496894409938
2020-07-28,666,960,1096,2722,24.46730345334313,35.268185157972084,40.264511388684795
2020-07-29,627,1044,930,2601,24.106113033448672,40.13840830449827,35.75547866205306
2020-07-30,520,920,905,2345,22.174840085287848,39.23240938166311,38.59275053304904
2020-07-31,632,948,898,2478,25.504439063761097,38.256658595641646,36.23890234059726
2020-08-01,500,681,733,1914,26.12330198537095,35.57993730407524,38.29676071055381
2020-08-02,500,655,639,1794,27.870680044593087,36.51059085841695,35.618729096989966
2020-08-03,635,833,751,2219,28.61649391617846,37.53943217665615,33.84407390716539
2020-08-04,637,884,813,2334,27.292202227934876,37.874892887746356,34.832904884318765
2020-08-05,625,786,893,2304,27.12673611111111,34.11458333333333,38.75868055555556
2020-08-06,697,943,866,2506,27.813248204309655,37.62968874700719,34.55706304868316
2020-08-07,817,1079,1027,2923,27.950735545672256,36.91412931919261,35.13513513513514
2020-08-08,768,964,963,2695,28.497217068645643,35.76994434137291,35.73283858998145
2020-08-09,609,857,865,2331,26.126126126126124,36.76533676533676,37.10853710853711
2020-08-10,700,967,975,2642,26.495079485238453,36.60105980317941,36.90386071158214
2020-08-11,687,991,989,2667,25.75928008998875,37.15785526809149,37.08286464191976
2020-08-12,712,1173,1014,2899,24.560193170058643,40.46222835460503,34.97757847533632
2020-08-13,664,1004,952,2620,25.34351145038168,38.3206106870229,36.33587786259542
2020-08-14,692,956,850,2498,27.702161729383505,38.27061649319455,34.02722177742194
2020-08-15,554,807,845,2206,25.11332728921124,36.58204895738894,38.30462375339982
2020-08-16,631,927,879,2437,25.89249076733689,38.03857201477226,36.06893721789085
2020-08-17,917,1255,1355,3527,25.99943294584633,35.582648142897646,38.417918911256024
2020-08-18,781,1166,1125,3072,25.423177083333332,37.95572916666667,36.62109375
2020-08-19,795,1080,975,2850,27.89473684210526,37.89473684210527,34.21052631578947
2020-08-20,751,1054,991,2796,26.85979971387697,37.6967095851216,35.44349070100143
2020-08-21,742,1030,1035,2807,26.433915211970078,36.693979337370855,36.87210545065906
2020-08-22,782,1017,1002,2801,27.918600499821494,36.308461263834346,35.77293823634417
2020-08-23,853,1179,1037,3069,27.7940697295536,38.41642228739003,33.789507983056374
2020-08-24,815,1085,1062,2962,27.5151924375422,36.63065496286293,35.85415259959487
2020-08-25,715,1099,1085,2899,24.663677130044842,37.90962400827872,37.426698861676435
2020-08-26,704,1050,1005,2759,25.516491482421166,38.0572671257702,36.42624139180863
2020-08-27,863,1101,1209,3173,27.198235108729907,34.69902300661834,38.10274188465175
2020-08-28,741,1139,980,2860,25.90909090909091,39.82517482517483,34.26573426573427
2020-08-29,590,824,814,2228,26.48114901256732,36.983842010771994,36.535008976660684
2020-08-30,551,764,773,2088,26.38888888888889,36.59003831417624,37.02107279693487
2020-08-31,666,891,913,2470,26.963562753036435,36.072874493927124,36.96356275303644
2020-09-01,635,1006,864,2505,25.349301397205586,40.159680638722556,34.49101796407186
2020-09-02,680,1018,886,2584,26.31578947368421,39.39628482972136,34.28792569659443
2020-09-03,954,1534,1414,3902,24.44900051255766,39.31317273193235,36.23782675550999
2020-09-04,1184,1617,1689,4490,26.369710467706014,36.01336302895323,37.61692650334076
2020-09-05,1308,1770,1653,4731,27.647431832593533,37.41280913126189,34.93975903614458
2020-09-06,1499,2296,2085,5880,25.493197278911566,39.04761904761905,35.45918367346938
2020-09-07,2239,3212,3189,8640,25.91435185185185,37.175925925925924,36.90972222222222
2020-09-08,1997,2966,2843,7806,25.58288496028696,37.996413015629,36.42070202408404
2020-09-09,2705,3866,3636,10207,26.5014205937102,37.87596747330264,35.62261193298716
2020-09-10,3662,4637,4199,12498,29.300688110097617,37.10193630980957,33.597375580092816
2020-09-11,2801,3608,3545,9954,28.139441430580668,36.2467349809122,35.61382358850713
2020-09-12,3726,4058,4254,12038,30.951985379631168,33.709918591128094,35.33809602924074
2020-09-13,2840,3404,3783,10027,28.323526478508025,33.94833948339483,37.72813403809714
2020-09-14,3938,5300,5463,14701,26.787293381402627,36.05196925379226,37.160737364805115
2020-09-15,5603,7075,6953,19631,28.541592379399926,36.03993683459834,35.418470786001734
2020-09-16,4044,5085,4620,13749,29.413048221688847,36.98450796421558,33.60244381409557
2020-09-17,2464,3466,2991,8921,27.62022194821208,38.85214662033405,33.52763143145388
2020-09-18,2366,3032,3008,8406,28.146561979538426,36.069474185105875,35.7839638353557
2020-09-19,1364,2124,1924,5412,25.203252032520325,39.24611973392461,35.55062823355507
2020-09-20,1300,1937,1868,5105,25.465230166503428,37.94319294809011,36.59157688540646
2020-09-21,1937,2860,2584,7381,26.2430564964097,38.74813710879285,35.00880639479745
2020-09-22,2062,3379,2558,7999,25.778222277784725,42.24278034754344,31.978997374671835
2020-09-23,1872,3511,2666,8049,23.257547521431235,43.62032550627407,33.122126972294694
2020-09-24,1846,3277,2832,7955,23.205531112507856,41.19421747328724,35.600251414204905
2020-09-25,1876,4477,3865,10218,18.359757291055,43.814836562928164,37.82540614601683
2020-09-26,1681,2526,2439,6646,25.293409569665965,38.00782425519109,36.69876617514294
2020-09-27,1422,2164,1982,5568,25.538793103448278,38.86494252873563,35.5962643678161
2020-09-28,1454,2430,2036,5920,24.56081081081081,41.0472972972973,34.39189189189189
2020-09-29,1468,2579,2159,6206,23.65452787624879,41.55655816951337,34.788913954237835
2020-09-30,3526,5061,5388,13975,25.23076923076923,36.21466905187836,38.55456171735241
2020-10-01,98,120,104,322,30.434782608695656,37.267080745341616,32.298136645962735
