Date,Negative,Positive,Neutral,Total,Percentage_neg,Percentage_pos,Percentage_neutr
2019-10-01,275,448,229,952,28.886554621848738,47.05882352941176,24.054621848739497
2019-10-02,383,560,277,1220,31.39344262295082,45.90163934426229,22.704918032786885
2019-10-03,287,391,191,869,33.026467203682394,44.99424626006904,21.979286536248562
2019-10-04,240,716,219,1175,20.425531914893615,60.93617021276596,18.638297872340427
2019-10-05,211,535,159,905,23.314917127071823,59.11602209944752,17.569060773480665
2019-10-06,157,406,108,671,23.39791356184799,60.50670640834576,16.095380029806257
2019-10-07,148,453,132,733,20.190995907230562,61.80081855388813,18.00818553888131
2019-10-08,235,457,197,889,26.43419572553431,51.40607424071991,22.15973003374578
2019-10-09,168,412,112,692,24.277456647398843,59.53757225433526,16.184971098265898
2019-10-10,212,484,166,862,24.593967517401392,56.148491879350345,19.25754060324826
2019-10-11,303,578,137,1018,29.764243614931235,56.777996070726914,13.457760314341845
2019-10-12,123,409,137,669,18.385650224215247,61.13602391629297,20.47832585949178
2019-10-13,196,362,125,683,28.69692532942899,53.00146412884333,18.301610541727673
2019-10-14,334,313,183,830,40.24096385542168,37.71084337349397,22.048192771084338
2019-10-15,213,456,183,852,25.0,53.52112676056338,21.47887323943662
2019-10-16,177,441,163,781,22.66325224071703,56.466069142125484,20.87067861715749
2019-10-17,140,331,135,606,23.1023102310231,54.62046204620462,22.277227722772277
2019-10-18,144,405,101,650,22.153846153846153,62.30769230769231,15.538461538461537
2019-10-19,120,193,108,421,28.50356294536817,45.843230403800476,25.653206650831358
2019-10-20,127,171,109,407,31.203931203931205,42.01474201474201,26.78132678132678
2019-10-21,177,258,108,543,32.59668508287293,47.51381215469613,19.88950276243094
2019-10-22,155,255,132,542,28.59778597785978,47.0479704797048,24.354243542435423
2019-10-23,531,431,215,1177,45.11469838572642,36.61852166525064,18.26677994902294
2019-10-24,717,612,305,1634,43.880048959608324,37.454100367197064,18.665850673194615
2019-10-25,371,344,174,889,41.732283464566926,38.69516310461192,19.572553430821145
2019-10-26,305,260,138,703,43.3854907539118,36.98435277382646,19.630156472261735
2019-10-27,278,231,141,650,42.769230769230774,35.53846153846154,21.69230769230769
2019-10-28,276,286,127,689,40.05805515239477,41.509433962264154,18.432510885341074
2019-10-29,188,265,128,581,32.358003442340795,45.61101549053356,22.030981067125648
2019-10-30,166,224,129,519,31.984585741811177,43.15992292870906,24.85549132947977
2019-10-31,161,171,106,438,36.757990867579906,39.04109589041096,24.200913242009133
2019-11-01,144,204,107,455,31.648351648351646,44.83516483516484,23.516483516483515
2019-11-02,138,173,90,401,34.413965087281795,43.14214463840399,22.443890274314214
2019-11-03,130,196,117,443,29.345372460496616,44.24379232505643,26.410835214446955
2019-11-04,165,220,112,497,33.199195171026155,44.26559356136821,22.535211267605636
2019-11-05,165,213,138,516,31.976744186046513,41.27906976744186,26.744186046511626
2019-11-06,127,195,97,419,30.310262529832936,46.53937947494033,23.15035799522673
2019-11-07,227,262,108,597,38.02345058626466,43.88609715242881,18.090452261306535
2019-11-08,237,270,117,624,37.980769230769226,43.269230769230774,18.75
2019-11-09,137,159,89,385,35.58441558441559,41.2987012987013,23.116883116883116
2019-11-10,133,149,89,371,35.84905660377358,40.16172506738545,23.98921832884097
2019-11-11,199,227,112,538,36.98884758364313,42.193308550185876,20.817843866171003
2019-11-12,176,188,151,515,34.1747572815534,36.50485436893204,29.320388349514566
2019-11-13,262,257,143,662,39.577039274924466,38.82175226586103,21.6012084592145
2019-11-14,748,673,344,1765,42.37960339943343,38.13031161473088,19.490084985835693
2019-11-15,426,475,264,1165,36.566523605150216,40.772532188841204,22.660944206008583
2019-11-16,216,259,111,586,36.86006825938566,44.19795221843004,18.941979522184297
2019-11-17,357,471,299,1127,31.67701863354037,41.79236912156167,26.53061224489796
2019-11-18,339,512,257,1108,30.595667870036102,46.20938628158845,23.19494584837545
2019-11-19,203,301,135,639,31.768388106416275,47.104851330203445,21.12676056338028
2019-11-20,208,257,113,578,35.98615916955018,44.463667820069205,19.55017301038062
2019-11-21,216,336,186,738,29.268292682926827,45.52845528455284,25.203252032520325
2019-11-22,206,241,120,567,36.33156966490299,42.504409171075835,21.164021164021165
2019-11-23,177,194,91,462,38.311688311688314,41.99134199134199,19.696969696969695
2019-11-24,189,181,120,490,38.57142857142858,36.93877551020408,24.489795918367346
2019-11-25,188,231,120,539,34.87940630797773,42.857142857142854,22.263450834879407
2019-11-26,190,245,133,568,33.45070422535211,43.13380281690141,23.41549295774648
2019-11-27,194,194,134,522,37.16475095785441,37.16475095785441,25.67049808429119
2019-11-28,201,262,120,583,34.476843910806174,44.93996569468268,20.58319039451115
2019-11-29,157,207,168,532,29.51127819548872,38.90977443609023,31.57894736842105
2019-11-30,263,301,245,809,32.509270704573545,37.20642768850433,30.284301606922128
2019-12-01,200,234,167,601,33.277870216306155,38.935108153078204,27.787021630615637
2019-12-02,250,333,163,746,33.51206434316354,44.638069705093834,21.84986595174263
2019-12-03,208,269,146,623,33.386837881219904,43.17817014446228,23.434991974317818
2019-12-04,215,270,104,589,36.502546689303905,45.840407470288625,17.65704584040747
2019-12-05,144,225,131,500,28.799999999999997,45.0,26.200000000000003
2019-12-06,199,277,137,613,32.46329526916802,45.18760195758564,22.34910277324633
2019-12-07,154,200,73,427,36.0655737704918,46.8384074941452,17.096018735362996
2019-12-08,230,291,188,709,32.44005641748942,41.04372355430183,26.516220028208743
2019-12-09,592,1032,465,2089,28.338918142651988,49.40162757300144,22.259454284346578
2019-12-10,385,490,242,1117,34.46732318710833,43.86750223813787,21.665174574753802
2019-12-11,279,304,160,743,37.55047106325707,40.915208613728126,21.534320323014803
2019-12-12,360,477,185,1022,35.22504892367906,46.67318982387476,18.101761252446185
2019-12-13,633,809,337,1779,35.58178752107926,45.47498594716133,18.943226531759414
2019-12-14,238,428,162,828,28.743961352657006,51.690821256038646,19.565217391304348
2019-12-15,215,281,136,632,34.01898734177215,44.462025316455694,21.518987341772153
2019-12-16,154,256,197,607,25.370675453047774,42.174629324546956,32.45469522240527
2019-12-17,240,335,168,743,32.3014804845222,45.08748317631225,22.611036339165544
2019-12-18,218,306,164,688,31.686046511627907,44.47674418604651,23.837209302325583
2019-12-19,195,294,165,654,29.81651376146789,44.95412844036697,25.229357798165136
2019-12-20,255,363,211,829,30.759951749095293,43.78769601930036,25.45235223160434
2019-12-21,193,286,143,622,31.028938906752412,45.98070739549839,22.990353697749196
2019-12-22,274,249,147,670,40.8955223880597,37.16417910447761,21.940298507462686
2019-12-23,153,221,128,502,30.47808764940239,44.02390438247012,25.49800796812749
2019-12-24,125,170,90,385,32.467532467532465,44.15584415584416,23.376623376623375
2019-12-25,102,150,75,327,31.19266055045872,45.87155963302752,22.93577981651376
2019-12-26,207,197,112,516,40.116279069767444,38.17829457364341,21.705426356589147
2019-12-27,216,243,128,587,36.79727427597956,41.396933560477,21.80579216354344
2019-12-28,284,181,104,569,49.91212653778559,31.810193321616868,18.27768014059754
2019-12-29,240,220,178,638,37.61755485893417,34.48275862068966,27.89968652037618
2019-12-30,375,225,155,755,49.668874172185426,29.80132450331126,20.52980132450331
2019-12-31,231,222,128,581,39.75903614457831,38.209982788296045,22.030981067125648
2020-01-01,184,207,85,476,38.655462184873954,43.48739495798319,17.857142857142858
2020-01-02,340,286,130,756,44.97354497354497,37.83068783068783,17.195767195767196
2020-01-03,181,198,115,494,36.63967611336032,40.08097165991903,23.279352226720647
2020-01-04,142,191,91,424,33.490566037735846,45.04716981132076,21.462264150943398
2020-01-05,174,185,117,476,36.554621848739494,38.865546218487395,24.579831932773107
2020-01-06,165,200,98,463,35.63714902807775,43.196544276457885,21.166306695464364
2020-01-07,180,254,104,538,33.457249070631974,47.21189591078067,19.33085501858736
2020-01-08,272,327,237,836,32.535885167464116,39.11483253588517,28.349282296650717
2020-01-09,306,550,252,1108,27.617328519855594,49.63898916967509,22.743682310469314
2020-01-10,215,347,193,755,28.47682119205298,45.96026490066225,25.562913907284766
2020-01-11,158,248,161,567,27.86596119929453,43.738977072310405,28.39506172839506
2020-01-12,161,237,115,513,31.384015594541907,46.198830409356724,22.417153996101362
2020-01-13,150,191,107,448,33.482142857142854,42.63392857142857,23.883928571428573
2020-01-14,213,224,128,565,37.69911504424779,39.64601769911504,22.654867256637168
2020-01-15,212,272,154,638,33.22884012539185,42.63322884012539,24.137931034482758
2020-01-16,172,256,145,573,30.017452006980804,44.67713787085515,25.30541012216405
2020-01-17,213,259,167,639,33.33333333333333,40.532081377151805,26.134585289514867
2020-01-18,171,239,109,519,32.947976878612714,46.05009633911368,21.001926782273603
2020-01-19,114,213,88,415,27.469879518072286,51.325301204819276,21.204819277108435
2020-01-20,255,372,180,807,31.59851301115242,46.09665427509294,22.304832713754646
2020-01-21,218,354,197,769,28.348504551365412,46.03381014304291,25.617685305591674
2020-01-22,301,453,273,1027,29.308666017526775,44.10905550146057,26.582278481012654
2020-01-23,249,334,208,791,31.479140328697852,42.22503160556258,26.295828065739567
2020-01-24,212,304,199,715,29.65034965034965,42.51748251748252,27.83216783216783
2020-01-25,196,280,138,614,31.921824104234524,45.60260586319218,22.475570032573287
2020-01-26,192,267,156,615,31.21951219512195,43.41463414634146,25.365853658536587
2020-01-27,283,484,250,1017,27.826941986234022,47.590953785644054,24.582104228121928
2020-01-28,242,391,217,850,28.47058823529412,46.0,25.529411764705884
2020-01-29,210,305,165,680,30.88235294117647,44.85294117647059,24.264705882352942
2020-01-30,201,349,207,757,26.55217965653897,46.10303830911493,27.344782034346103
2020-01-31,314,531,218,1063,29.53904045155221,49.95296331138288,20.50799623706491
2020-02-01,277,441,275,993,27.895266868076536,44.41087613293052,27.69385699899295
2020-02-02,254,361,177,792,32.07070707070707,45.58080808080808,22.348484848484848
2020-02-03,173,249,133,555,31.17117117117117,44.86486486486487,23.963963963963963
2020-02-04,154,191,139,484,31.818181818181817,39.46280991735537,28.719008264462808
2020-02-05,192,270,139,601,31.94675540765391,44.92512479201331,23.128119800332776
2020-02-06,236,243,127,606,38.943894389438945,40.099009900990104,20.957095709570957
2020-02-07,215,227,114,556,38.669064748201436,40.827338129496404,20.503597122302157
2020-02-08,265,235,142,642,41.27725856697819,36.60436137071651,22.118380062305295
2020-02-09,388,221,138,747,51.941097724230254,29.58500669344043,18.473895582329316
2020-02-10,303,282,145,730,41.50684931506849,38.63013698630137,19.863013698630137
2020-02-11,298,248,165,711,41.91279887482419,34.88045007032349,23.20675105485232
2020-02-12,252,231,199,682,36.950146627565985,33.87096774193548,29.178885630498534
2020-02-13,197,236,121,554,35.55956678700361,42.59927797833935,21.841155234657037
2020-02-14,176,173,117,466,37.76824034334764,37.1244635193133,25.10729613733906
2020-02-15,143,224,149,516,27.71317829457364,43.41085271317829,28.875968992248062
2020-02-16,142,136,85,363,39.11845730027548,37.46556473829201,23.415977961432507
2020-02-17,150,128,103,381,39.37007874015748,33.59580052493438,27.034120734908136
2020-02-18,126,215,138,479,26.304801670146137,44.88517745302714,28.81002087682672
2020-02-19,688,1439,549,2676,25.710014947683106,53.77428998505231,20.515695067264573
2020-02-20,458,754,318,1530,29.934640522875817,49.28104575163399,20.784313725490197
2020-02-21,545,807,349,1701,32.039976484420926,47.44268077601411,20.517342739564963
2020-02-22,282,424,180,886,31.82844243792325,47.855530474040634,20.31602708803612
2020-02-23,210,294,125,629,33.38632750397456,46.74085850556439,19.87281399046105
2020-02-24,172,281,145,598,28.762541806020064,46.98996655518395,24.24749163879599
2020-02-25,165,238,119,522,31.60919540229885,45.593869731800766,22.796934865900383
2020-02-26,162,217,127,506,32.015810276679844,42.88537549407115,25.09881422924901
2020-02-27,207,261,137,605,34.21487603305785,43.1404958677686,22.644628099173552
2020-02-28,244,292,189,725,33.6551724137931,40.275862068965516,26.068965517241377
2020-02-29,198,257,164,619,31.98707592891761,41.51857835218094,26.494345718901453
2020-03-01,190,271,161,622,30.54662379421222,43.569131832797424,25.884244372990356
2020-03-02,277,392,413,1082,25.600739371534196,36.22920517560074,38.170055452865064
2020-03-03,250,311,211,772,32.38341968911917,40.284974093264246,27.33160621761658
2020-03-04,232,289,211,732,31.693989071038253,39.48087431693989,28.825136612021858
2020-03-05,260,299,196,755,34.437086092715234,39.602649006622514,25.96026490066225
2020-03-06,171,290,154,615,27.80487804878049,47.15447154471545,25.040650406504067
2020-03-07,198,272,138,608,32.56578947368421,44.73684210526316,22.697368421052634
2020-03-08,238,291,133,662,35.95166163141994,43.957703927492446,20.090634441087612
2020-03-09,171,231,125,527,32.44781783681214,43.833017077798864,23.719165085388994
2020-03-10,211,229,158,598,35.28428093645485,38.29431438127091,26.421404682274247
2020-03-11,242,326,233,801,30.21223470661673,40.69912609238452,29.08863920099875
2020-03-12,505,691,539,1735,29.106628242074926,39.82708933717579,31.066282420749282
2020-03-13,309,404,221,934,33.08351177730193,43.25481798715203,23.66167023554604
2020-03-14,301,370,241,912,33.00438596491228,40.57017543859649,26.42543859649123
2020-03-15,342,410,265,1017,33.6283185840708,40.31465093411996,26.05703048180924
2020-03-16,413,439,295,1147,36.00697471665214,38.273757628596336,25.719267654751526
2020-03-17,288,380,233,901,31.96448390677026,42.17536071032186,25.86015538290788
2020-03-18,233,285,168,686,33.965014577259474,41.54518950437318,24.489795918367346
2020-03-19,247,250,160,657,37.595129375951295,38.051750380517504,24.3531202435312
2020-03-20,240,215,137,592,40.54054054054054,36.317567567567565,23.14189189189189
2020-03-21,212,225,148,585,36.23931623931624,38.46153846153847,25.299145299145298
2020-03-22,304,244,198,746,40.75067024128686,32.707774798927616,26.541554959785525
2020-03-23,330,293,237,860,38.372093023255815,34.06976744186046,27.55813953488372
2020-03-24,195,205,118,518,37.64478764478765,39.575289575289574,22.779922779922778
2020-03-25,276,278,115,669,41.25560538116592,41.554559043348284,17.189835575485798
2020-03-26,327,382,166,875,37.371428571428574,43.65714285714286,18.97142857142857
2020-03-27,208,225,143,576,36.11111111111111,39.0625,24.82638888888889
2020-03-28,174,199,108,481,36.17463617463618,41.37214137214137,22.453222453222455
2020-03-29,220,244,131,595,36.97478991596639,41.008403361344534,22.016806722689076
2020-03-30,247,218,148,613,40.29363784665579,35.56280587275693,24.143556280587276
2020-03-31,143,154,118,415,34.4578313253012,37.10843373493976,28.433734939759038
2020-04-01,211,210,151,572,36.888111888111894,36.71328671328671,26.3986013986014
2020-04-02,189,207,130,526,35.93155893536122,39.353612167300376,24.714828897338403
2020-04-03,156,169,111,436,35.77981651376147,38.76146788990826,25.458715596330272
2020-04-04,182,192,125,499,36.47294589178357,38.476953907815634,25.0501002004008
2020-04-05,193,162,103,458,42.13973799126637,35.37117903930131,22.489082969432314
2020-04-06,152,169,170,491,30.95723014256619,34.419551934826885,34.623217922606926
2020-04-07,235,352,196,783,30.01277139208174,44.95530012771392,25.03192848020434
2020-04-08,293,284,177,754,38.85941644562334,37.6657824933687,23.47480106100796
2020-04-09,314,310,184,808,38.86138613861386,38.366336633663366,22.772277227722775
2020-04-10,255,233,132,620,41.12903225806452,37.58064516129032,21.29032258064516
2020-04-11,251,280,131,662,37.91540785498489,42.296072507552864,19.788519637462233
2020-04-12,301,358,217,876,34.36073059360731,40.8675799086758,24.771689497716896
2020-04-13,340,397,174,911,37.32162458836443,43.578485181119646,19.099890230515918
2020-04-14,263,297,142,702,37.464387464387464,42.30769230769231,20.22792022792023
2020-04-15,349,471,270,1090,32.01834862385321,43.211009174311926,24.770642201834864
2020-04-16,415,406,223,1044,39.75095785440613,38.88888888888889,21.36015325670498
2020-04-17,357,403,222,982,36.354378818737274,41.03869653767821,22.606924643584524
2020-04-18,313,239,146,698,44.84240687679083,34.240687679083095,20.916905444126073
2020-04-19,241,252,162,655,36.79389312977099,38.47328244274809,24.732824427480914
2020-04-20,213,264,139,616,34.57792207792208,42.857142857142854,22.564935064935064
2020-04-21,304,250,173,727,41.81568088033013,34.3878954607978,23.796423658872076
2020-04-22,238,233,129,600,39.666666666666664,38.83333333333333,21.5
2020-04-23,194,276,141,611,31.751227495908346,45.171849427168574,23.076923076923077
2020-04-24,199,374,123,696,28.59195402298851,53.735632183908045,17.67241379310345
2020-04-25,273,210,140,623,43.82022471910113,33.70786516853933,22.47191011235955
2020-04-26,387,300,180,867,44.636678200692046,34.602076124567475,20.761245674740483
2020-04-27,346,331,171,848,40.80188679245283,39.03301886792453,20.16509433962264
2020-04-28,328,308,165,801,40.94881398252185,38.45193508114856,20.59925093632959
2020-04-29,387,305,164,856,45.21028037383177,35.63084112149533,19.158878504672895
2020-04-30,282,285,129,696,40.51724137931034,40.94827586206897,18.53448275862069
2020-05-01,246,211,112,569,43.23374340949033,37.08260105448154,19.68365553602812
2020-05-02,146,172,79,397,36.775818639798494,43.32493702770781,19.899244332493705
2020-05-03,279,238,147,664,42.01807228915663,35.8433734939759,22.13855421686747
2020-05-04,312,277,219,808,38.613861386138616,34.28217821782179,27.103960396039607
2020-05-05,499,425,177,1101,45.322434150772025,38.60127157129882,16.076294277929154
2020-05-06,387,338,139,864,44.79166666666667,39.120370370370374,16.087962962962962
2020-05-07,377,342,162,881,42.79228149829739,38.819523269012485,18.388195232690123
2020-05-08,450,391,155,996,45.18072289156627,39.2570281124498,15.562248995983936
2020-05-09,776,517,239,1532,50.65274151436031,33.746736292428196,15.60052219321149
2020-05-10,517,391,195,1103,46.87216681776972,35.44877606527652,17.67905711695376
2020-05-11,588,462,273,1323,44.44444444444444,34.92063492063492,20.634920634920633
2020-05-12,510,425,250,1185,43.037974683544306,35.86497890295359,21.09704641350211
2020-05-13,395,335,166,896,44.08482142857143,37.388392857142854,18.526785714285715
2020-05-14,265,274,139,678,39.08554572271387,40.41297935103245,20.50147492625369
2020-05-15,252,261,151,664,37.95180722891566,39.30722891566265,22.740963855421686
2020-05-16,295,294,156,745,39.59731543624161,39.46308724832215,20.93959731543624
2020-05-17,648,393,188,1229,52.72579332790887,31.97721724979658,15.29698942229455
2020-05-18,571,653,293,1517,37.64007910349374,43.04548450889914,19.31443638760712
2020-05-19,542,678,270,1490,36.375838926174495,45.50335570469798,18.120805369127517
2020-05-20,621,555,302,1478,42.01623815967523,37.55074424898511,20.43301759133965
2020-05-21,1581,960,376,2917,54.19952005485087,32.910524511484404,12.889955433664724
2020-05-22,1036,727,329,2092,49.521988527724666,34.75143403441683,15.726577437858507
2020-05-23,416,309,161,886,46.95259593679458,34.87584650112866,18.17155756207675
2020-05-24,496,300,341,1137,43.6235708003518,26.385224274406333,29.991204925241867
2020-05-25,254,198,120,572,44.40559440559441,34.61538461538461,20.97902097902098
2020-05-26,316,307,189,812,38.91625615763547,37.80788177339902,23.275862068965516
2020-05-27,376,295,177,848,44.339622641509436,34.7877358490566,20.87264150943396
2020-05-28,297,305,182,784,37.88265306122449,38.9030612244898,23.214285714285715
2020-05-29,250,301,147,698,35.816618911174785,43.12320916905444,21.060171919770774
2020-05-30,291,291,163,745,39.06040268456376,39.06040268456376,21.879194630872483
2020-05-31,214,254,127,595,35.96638655462185,42.6890756302521,21.34453781512605
2020-06-01,225,225,313,763,29.48885976408912,29.48885976408912,41.02228047182175
2020-06-02,306,318,239,863,35.4577056778679,36.848203939745076,27.69409038238702
2020-06-03,572,495,308,1375,41.6,36.0,22.400000000000002
2020-06-04,482,426,237,1145,42.096069868995635,37.20524017467249,20.69868995633188
2020-06-05,382,334,183,899,42.49165739710789,37.1523915461624,20.355951056729698
2020-06-06,239,273,164,676,35.35502958579882,40.38461538461539,24.2603550295858
2020-06-07,305,291,157,753,40.504648074369186,38.645418326693225,20.849933598937582
2020-06-08,375,394,213,982,38.187372708757636,40.122199592668025,21.69042769857434
2020-06-09,299,316,171,786,38.040712468193384,40.20356234096692,21.755725190839694
2020-06-10,270,354,183,807,33.457249070631974,43.866171003717476,22.676579925650557
2020-06-11,339,422,178,939,36.102236421725244,44.94142705005325,18.956336528221513
2020-06-12,277,385,201,863,32.0973348783314,44.61181923522596,23.290845886442643
2020-06-13,261,266,136,663,39.366515837104075,40.120663650075414,20.51282051282051
2020-06-14,256,232,156,644,39.75155279503105,36.024844720496894,24.22360248447205
2020-06-15,268,410,265,943,28.419936373276776,43.47826086956522,28.101802757158005
2020-06-16,499,623,310,1432,34.8463687150838,43.505586592178766,21.648044692737432
2020-06-17,606,353,200,1159,52.286453839516824,30.457290767903366,17.25625539257981
2020-06-18,412,363,197,972,42.38683127572017,37.34567901234568,20.267489711934157
2020-06-19,261,383,159,803,32.50311332503114,47.6961394769614,19.80074719800747
2020-06-20,302,501,268,1071,28.197945845004668,46.778711484593835,25.023342670401494
2020-06-21,707,509,351,1567,45.118059987236755,32.48245054243778,22.399489470325463
2020-06-22,532,447,334,1313,40.51789794364052,34.04417364813405,25.437928408225435
2020-06-23,400,379,181,960,41.66666666666667,39.479166666666664,18.854166666666668
2020-06-24,289,288,358,935,30.909090909090907,30.802139037433157,38.288770053475936
2020-06-25,260,236,245,741,35.08771929824561,31.84885290148448,33.063427800269906
2020-06-26,637,538,276,1451,43.90075809786354,37.07787732598209,19.021364576154376
2020-06-27,633,460,236,1329,47.629796839729124,34.612490594431904,17.757712565838975
2020-06-28,369,398,209,976,37.80737704918033,40.77868852459016,21.41393442622951
2020-06-29,364,346,210,920,39.565217391304344,37.608695652173914,22.82608695652174
2020-06-30,360,512,206,1078,33.39517625231911,47.49536178107607,19.109461966604822
2020-07-01,545,892,400,1837,29.667936853565596,48.55743059335874,21.77463255307567
2020-07-02,355,541,290,1186,29.932546374367625,45.61551433389545,24.45193929173693
2020-07-03,331,329,181,841,39.35790725326992,39.12009512485137,21.521997621878715
2020-07-04,196,253,140,589,33.276740237691,42.95415959252971,23.769100169779286
2020-07-05,190,224,121,535,35.51401869158878,41.86915887850468,22.61682242990654
2020-07-06,215,234,154,603,35.65505804311774,38.80597014925373,25.538971807628524
2020-07-07,288,303,199,790,36.45569620253165,38.35443037974684,25.18987341772152
2020-07-08,261,279,154,694,37.60806916426513,40.20172910662824,22.19020172910663
2020-07-09,203,219,123,545,37.247706422018354,40.18348623853211,22.568807339449542
2020-07-10,181,241,119,541,33.45656192236599,44.54713493530499,21.996303142329023
2020-07-11,150,170,72,392,38.265306122448976,43.36734693877551,18.367346938775512
2020-07-12,315,385,174,874,36.04118993135012,44.05034324942792,19.908466819221967
2020-07-13,414,536,282,1232,33.603896103896105,43.506493506493506,22.88961038961039
2020-07-14,315,353,253,921,34.20195439739413,38.327904451682954,27.47014115092291
2020-07-15,292,346,161,799,36.545682102628284,43.30413016270338,20.150187734668336
2020-07-16,333,332,212,877,37.97035347776511,37.8563283922463,24.173318129988598
2020-07-17,217,216,139,572,37.93706293706294,37.76223776223776,24.3006993006993
2020-07-18,327,279,151,757,43.196829590488775,36.85601056803171,19.947159841479525
2020-07-19,298,292,133,723,41.21715076071922,40.387275242047025,18.39557399723375
2020-07-20,216,227,107,550,39.27272727272727,41.27272727272727,19.454545454545453
2020-07-21,337,394,135,866,38.91454965357968,45.49653579676674,15.588914549653579
2020-07-22,404,315,128,847,47.69775678866588,37.1900826446281,15.11216056670602
2020-07-23,358,314,160,832,43.02884615384615,37.74038461538461,19.230769230769234
2020-07-24,230,209,123,562,40.92526690391459,37.18861209964413,21.88612099644128
2020-07-25,291,228,138,657,44.29223744292237,34.70319634703196,21.00456621004566
2020-07-26,212,194,102,508,41.732283464566926,38.188976377952756,20.078740157480315
2020-07-27,199,212,95,506,39.32806324110672,41.89723320158103,18.774703557312254
2020-07-28,416,510,183,1109,37.51127141568981,45.98737601442741,16.501352569882776
2020-07-29,337,364,171,872,38.646788990825684,41.74311926605505,19.610091743119266
2020-07-30,850,511,225,1586,53.593947036569986,32.219419924337956,14.186633039092056
2020-07-31,803,578,223,1604,50.062344139650875,36.03491271820449,13.902743142144638
2020-08-01,490,374,132,996,49.19678714859438,37.55020080321285,13.253012048192772
2020-08-02,349,312,129,790,44.17721518987342,39.49367088607595,16.329113924050635
2020-08-03,297,253,147,697,42.61119081779053,36.29842180774749,21.09038737446198
2020-08-04,925,490,219,1634,56.60954712362302,29.98776009791922,13.402692778457773
2020-08-05,773,431,262,1466,52.72851296043656,29.39972714870396,17.871759890859483
2020-08-06,987,528,282,1797,54.92487479131887,29.382303839732888,15.692821368948248
2020-08-07,1855,1262,558,3675,50.476190476190474,34.34013605442176,15.183673469387754
2020-08-08,2822,2368,1135,6325,44.616600790513836,37.43873517786561,17.94466403162055
2020-08-09,2580,2326,1138,6044,42.68696227663799,38.48444738583719,18.828590337524815
2020-08-10,2212,2074,2604,6890,32.10449927431059,30.101596516690854,37.79390420899855
2020-08-11,2883,2959,2622,8464,34.061909262759926,34.959829867674856,30.978260869565215
2020-08-12,2328,2222,1339,5889,39.531329597554766,37.73136355917813,22.737306843267106
2020-08-13,1333,1131,688,3152,42.29060913705584,35.88197969543147,21.82741116751269
2020-08-14,1097,817,515,2429,45.162618361465626,33.6352408398518,21.202140798682585
2020-08-15,733,609,378,1720,42.616279069767444,35.406976744186046,21.976744186046513
2020-08-16,1169,849,441,2459,47.5396502643351,34.526230174867834,17.934119560797072
2020-08-17,777,620,397,1794,43.31103678929766,34.55964325529543,22.129319955406913
2020-08-18,645,496,243,1384,46.604046242774565,35.83815028901734,17.557803468208093
2020-08-19,1697,1612,784,4093,41.46103102858539,39.384314683606156,19.154654287808455
2020-08-20,1280,1343,542,3165,40.44233807266983,42.43285939968404,17.12480252764613
2020-08-21,1041,970,464,2475,42.06060606060606,39.1919191919192,18.747474747474747
2020-08-22,659,633,301,1593,41.368487131199,39.73634651600753,18.89516635279347
2020-08-23,473,397,226,1096,43.15693430656935,36.222627737226276,20.62043795620438
2020-08-24,329,333,181,843,39.02728351126928,39.50177935943061,21.47093712930012
2020-08-25,551,522,201,1274,43.24960753532182,40.97331240188383,15.777080062794349
2020-08-26,383,387,180,950,40.31578947368421,40.73684210526316,18.947368421052634
2020-08-27,699,762,303,1764,39.625850340136054,43.197278911564624,17.17687074829932
2020-08-28,800,675,298,1773,45.121263395375074,38.07106598984771,16.807670614777216
2020-08-29,490,395,208,1093,44.83074107959744,36.13906678865508,19.030192131747484
2020-08-30,355,341,151,847,41.91263282172373,40.25974025974026,17.827626918536012
2020-08-31,350,379,185,914,38.29321663019694,41.46608315098469,20.24070021881838
2020-09-01,312,331,192,835,37.365269461077844,39.64071856287425,22.994011976047904
2020-09-02,678,755,235,1668,40.647482014388494,45.26378896882494,14.088729016786573
2020-09-03,1812,1914,889,4615,39.26327193932828,41.473456121343446,19.263271939328277
2020-09-04,901,892,463,2256,39.937943262411345,39.53900709219858,20.52304964539007
2020-09-05,653,567,304,1524,42.84776902887139,37.20472440944882,19.94750656167979
2020-09-06,514,414,204,1132,45.40636042402827,36.57243816254417,18.021201413427562
2020-09-07,514,439,289,1242,41.38486312399356,35.34621578099839,23.268921095008054
2020-09-08,471,468,209,1148,41.027874564459935,40.76655052264808,18.205574912891986
2020-09-09,501,395,177,1073,46.69151910531221,36.81267474370923,16.495806150978567
2020-09-10,441,367,219,1027,42.94060370009737,35.73515092502434,21.324245374878288
2020-09-11,498,384,552,1434,34.72803347280335,26.778242677824267,38.49372384937239
2020-09-12,554,453,409,1416,39.12429378531073,31.991525423728813,28.88418079096045
2020-09-13,363,383,259,1005,36.11940298507463,38.1094527363184,25.771144278606968
2020-09-14,404,337,181,922,43.817787418655094,36.55097613882863,19.63123644251627
2020-09-15,474,388,201,1063,44.590780809031045,36.50047036688618,18.908748824082785
2020-09-16,498,480,261,1239,40.19370460048426,38.7409200968523,21.06537530266344
2020-09-17,547,451,256,1254,43.620414673046255,35.96491228070175,20.414673046251995
2020-09-18,453,384,167,1004,45.1195219123506,38.24701195219124,16.633466135458168
2020-09-19,284,232,151,667,42.578710644677656,34.78260869565217,22.638680659670165
2020-09-20,279,287,146,712,39.18539325842696,40.30898876404495,20.50561797752809
2020-09-21,300,278,139,717,41.84100418410041,38.77266387726639,19.386331938633194
2020-09-22,584,446,350,1380,42.31884057971014,32.31884057971015,25.36231884057971
2020-09-23,547,573,298,1418,38.57545839210155,40.40902679830747,21.015514809590975
2020-09-24,390,324,188,902,43.23725055432372,35.92017738359202,20.84257206208426
2020-09-25,317,285,129,731,43.365253077975375,38.98768809849521,17.647058823529413
2020-09-26,308,229,138,675,45.62962962962963,33.925925925925924,20.444444444444446
2020-09-27,238,293,136,667,35.68215892053973,43.92803598200899,20.389805097451273
2020-09-28,219,388,153,760,28.815789473684212,51.05263157894737,20.13157894736842
2020-09-29,313,398,246,957,32.70637408568443,41.588296760710556,25.705329153605017
2020-09-30,507,633,299,1439,35.23280055594162,43.988881167477416,20.778318276580958
