Date,Negative,Positive,Neutral,Total,Percentage_neg,Percentage_pos,Percentage_neutr
2015-10-01,67,263,163,493,13.590263691683571,53.34685598377283,33.062880324543606
2015-10-02,47,256,139,442,10.633484162895927,57.9185520361991,31.447963800904976
2015-10-03,39,194,128,361,10.80332409972299,53.73961218836565,35.45706371191136
2015-10-04,29,138,79,246,11.788617886178862,56.09756097560976,32.113821138211385
2015-10-05,43,230,131,404,10.643564356435643,56.930693069306926,32.42574257425743
2015-10-06,57,252,130,439,12.984054669703873,57.40318906605923,29.6127562642369
2015-10-07,53,211,159,423,12.529550827423167,49.881796690307326,37.5886524822695
2015-10-08,27,195,158,380,7.105263157894736,51.31578947368421,41.578947368421055
2015-10-09,51,280,436,767,6.6492829204693615,36.50586701434159,56.84485006518904
2015-10-10,39,270,399,708,5.508474576271186,38.13559322033898,56.355932203389834
2015-10-11,44,186,184,414,10.628019323671497,44.927536231884055,44.44444444444444
2015-10-12,64,200,207,471,13.588110403397028,42.462845010615716,43.94904458598726
2015-10-13,87,231,144,462,18.83116883116883,50.0,31.16883116883117
2015-10-14,79,217,140,436,18.11926605504587,49.77064220183486,32.11009174311927
2015-10-15,34,222,134,390,8.717948717948717,56.92307692307692,34.35897435897436
2015-10-16,35,175,131,341,10.263929618768328,51.31964809384164,38.41642228739003
2015-10-17,35,117,78,230,15.217391304347828,50.8695652173913,33.91304347826087
2015-10-18,27,105,71,203,13.30049261083744,51.724137931034484,34.97536945812808
2015-10-19,38,161,121,320,11.875,50.31250000000001,37.8125
2015-10-20,44,230,126,400,11.0,57.49999999999999,31.5
2015-10-21,29,199,107,335,8.656716417910449,59.40298507462687,31.94029850746269
2015-10-22,39,217,83,339,11.504424778761061,64.0117994100295,24.48377581120944
2015-10-23,45,214,112,371,12.129380053908356,57.68194070080862,30.18867924528302
2015-10-24,55,161,94,310,17.741935483870968,51.935483870967744,30.32258064516129
2015-10-25,147,165,208,520,28.26923076923077,31.73076923076923,40.0
2015-10-26,59,215,80,354,16.666666666666664,60.73446327683616,22.598870056497177
2015-10-27,39,224,95,358,10.893854748603351,62.56983240223464,26.536312849162012
2015-10-28,41,221,131,393,10.432569974554708,56.234096692111954,33.33333333333333
2015-10-29,101,234,164,499,20.240480961923847,46.893787575150306,32.86573146292585
2015-10-30,44,221,159,424,10.377358490566039,52.12264150943396,37.5
2015-10-31,28,183,102,313,8.945686900958465,58.46645367412141,32.587859424920126
2015-11-01,21,143,129,293,7.167235494880546,48.80546075085324,44.027303754266214
2015-11-02,61,203,158,422,14.454976303317535,48.1042654028436,37.44075829383886
2015-11-03,35,229,142,406,8.620689655172415,56.40394088669951,34.97536945812808
2015-11-04,35,233,177,445,7.865168539325842,52.359550561797754,39.7752808988764
2015-11-05,54,207,122,383,14.099216710182768,54.04699738903395,31.853785900783286
2015-11-06,31,186,82,299,10.367892976588628,62.207357859531776,27.424749163879596
2015-11-07,29,132,89,250,11.600000000000001,52.800000000000004,35.6
2015-11-08,36,133,88,257,14.007782101167315,51.75097276264592,34.24124513618677
2015-11-09,66,238,125,429,15.384615384615385,55.47785547785548,29.13752913752914
2015-11-10,35,200,80,315,11.11111111111111,63.49206349206349,25.396825396825395
2015-11-11,30,171,78,279,10.75268817204301,61.29032258064516,27.956989247311824
2015-11-12,32,203,102,337,9.495548961424333,60.23738872403561,30.267062314540063
2015-11-13,42,249,115,406,10.344827586206897,61.330049261083744,28.32512315270936
2015-11-14,23,136,119,278,8.273381294964029,48.92086330935252,42.805755395683455
2015-11-15,22,177,85,284,7.746478873239436,62.323943661971825,29.929577464788732
2015-11-16,88,244,80,412,21.35922330097087,59.22330097087378,19.41747572815534
2015-11-17,53,232,107,392,13.520408163265307,59.183673469387756,27.29591836734694
2015-11-18,76,188,150,414,18.357487922705314,45.410628019323674,36.231884057971016
2015-11-19,157,287,176,620,25.322580645161292,46.29032258064516,28.387096774193548
2015-11-20,129,325,179,633,20.379146919431278,51.342812006319114,28.278041074249604
2015-11-21,49,203,89,341,14.369501466275661,59.530791788856305,26.099706744868033
2015-11-22,46,177,111,334,13.77245508982036,52.99401197604791,33.23353293413174
2015-11-23,47,226,152,425,11.058823529411764,53.17647058823529,35.76470588235294
2015-11-24,48,264,103,415,11.566265060240964,63.614457831325296,24.819277108433734
2015-11-25,50,237,172,459,10.893246187363834,51.633986928104584,37.47276688453159
2015-11-26,45,274,180,499,9.01803607214429,54.90981963927856,36.07214428857716
2015-11-27,125,273,159,557,22.44165170556553,49.012567324955114,28.545780969479356
2015-11-28,62,184,91,337,18.397626112759642,54.59940652818991,27.002967359050444
2015-11-29,31,214,58,303,10.231023102310232,70.62706270627062,19.141914191419144
2015-11-30,39,231,106,376,10.372340425531915,61.43617021276596,28.191489361702125
2015-12-01,50,211,108,369,13.550135501355012,57.18157181571816,29.268292682926827
2015-12-02,64,196,88,348,18.39080459770115,56.32183908045977,25.287356321839084
2015-12-03,70,182,103,355,19.718309859154928,51.267605633802816,29.014084507042252
2015-12-04,91,219,89,399,22.807017543859647,54.88721804511278,22.305764411027567
2015-12-05,26,143,48,217,11.981566820276496,65.89861751152074,22.119815668202765
2015-12-06,54,126,53,233,23.17596566523605,54.077253218884124,22.746781115879827
2015-12-07,40,195,105,340,11.76470588235294,57.35294117647059,30.88235294117647
2015-12-08,43,247,118,408,10.53921568627451,60.5392156862745,28.921568627450984
2015-12-09,84,213,90,387,21.705426356589147,55.03875968992248,23.25581395348837
2015-12-10,74,214,82,370,20.0,57.83783783783784,22.162162162162165
2015-12-11,27,197,63,287,9.40766550522648,68.6411149825784,21.951219512195124
2015-12-12,30,159,68,257,11.673151750972762,61.86770428015564,26.459143968871597
2015-12-13,37,179,93,309,11.974110032362459,57.92880258899677,30.097087378640776
2015-12-14,59,228,123,410,14.390243902439023,55.60975609756098,30.0
2015-12-15,37,184,103,324,11.419753086419753,56.79012345679012,31.790123456790127
2015-12-16,112,248,105,465,24.086021505376344,53.333333333333336,22.58064516129032
2015-12-17,56,218,105,379,14.775725593667547,57.519788918205805,27.70448548812665
2015-12-18,41,213,93,347,11.815561959654179,61.38328530259366,26.801152737752158
2015-12-19,35,176,39,250,14.000000000000002,70.39999999999999,15.6
2015-12-20,29,148,81,258,11.24031007751938,57.36434108527132,31.3953488372093
2015-12-21,29,182,64,275,10.545454545454545,66.18181818181819,23.272727272727273
2015-12-22,34,177,78,289,11.76470588235294,61.245674740484425,26.989619377162633
2015-12-23,43,166,77,286,15.034965034965033,58.04195804195804,26.923076923076923
2015-12-24,42,155,97,294,14.285714285714285,52.721088435374156,32.99319727891156
2015-12-25,19,90,31,140,13.571428571428571,64.28571428571429,22.142857142857142
2015-12-26,31,119,41,191,16.230366492146597,62.30366492146597,21.465968586387437
2015-12-27,23,112,78,213,10.7981220657277,52.58215962441315,36.61971830985916
2015-12-28,32,143,68,243,13.168724279835391,58.8477366255144,27.983539094650205
2015-12-29,49,192,72,313,15.654952076677317,61.34185303514377,23.003194888178914
2015-12-30,41,237,167,445,9.213483146067416,53.25842696629214,37.52808988764045
2015-12-31,36,160,97,293,12.286689419795222,54.60750853242321,33.105802047781566
2016-01-01,29,142,82,253,11.462450592885375,56.126482213438734,32.41106719367589
2016-01-02,55,216,287,558,9.85663082437276,38.70967741935484,51.4336917562724
2016-01-03,34,140,88,262,12.977099236641221,53.43511450381679,33.587786259541986
2016-01-04,78,181,680,939,8.30670926517572,19.275825346112885,72.4174653887114
2016-01-05,182,289,145,616,29.545454545454547,46.91558441558442,23.53896103896104
2016-01-06,186,336,141,663,28.054298642533936,50.678733031674206,21.266968325791854
2016-01-07,65,232,168,465,13.978494623655912,49.89247311827957,36.12903225806451
2016-01-08,60,182,140,382,15.706806282722512,47.64397905759162,36.64921465968586
2016-01-09,46,188,89,323,14.241486068111456,58.204334365325074,27.55417956656347
2016-01-10,50,212,130,392,12.755102040816327,54.08163265306123,33.16326530612245
2016-01-11,53,150,139,342,15.497076023391813,43.859649122807014,40.643274853801174
2016-01-12,33,142,80,255,12.941176470588237,55.68627450980392,31.372549019607842
2016-01-13,30,217,116,363,8.264462809917356,59.77961432506888,31.955922865013775
2016-01-14,98,227,175,500,19.6,45.4,35.0
2016-01-15,93,217,124,434,21.428571428571427,50.0,28.57142857142857
2016-01-16,37,127,114,278,13.309352517985612,45.68345323741007,41.007194244604314
2016-01-17,47,153,103,303,15.51155115511551,50.495049504950494,33.993399339933994
2016-01-18,59,131,85,275,21.454545454545453,47.63636363636364,30.909090909090907
2016-01-19,62,249,103,414,14.975845410628018,60.14492753623188,24.879227053140095
2016-01-20,88,299,195,582,15.120274914089347,51.37457044673539,33.50515463917525
2016-01-21,148,445,98,691,21.41823444283647,64.39942112879883,14.182344428364688
2016-01-22,74,243,135,452,16.371681415929203,53.76106194690266,29.867256637168143
2016-01-23,48,176,113,337,14.243323442136498,52.22551928783383,33.531157270029674
2016-01-24,42,113,88,243,17.28395061728395,46.50205761316872,36.21399176954733
2016-01-25,42,150,108,300,14.000000000000002,50.0,36.0
2016-01-26,51,215,125,391,13.043478260869565,54.987212276214834,31.9693094629156
2016-01-27,50,203,128,381,13.123359580052494,53.28083989501312,33.59580052493438
2016-01-28,66,218,160,444,14.864864864864865,49.0990990990991,36.03603603603604
2016-01-29,46,186,146,378,12.16931216931217,49.2063492063492,38.62433862433862
2016-01-30,67,181,153,401,16.708229426433917,45.137157107231914,38.15461346633416
2016-01-31,42,147,113,302,13.90728476821192,48.675496688741724,37.41721854304636
2016-02-01,49,199,141,389,12.596401028277635,51.156812339331616,36.246786632390744
2016-02-02,54,207,173,434,12.442396313364055,47.69585253456221,39.86175115207373
2016-02-03,56,223,249,528,10.606060606060606,42.234848484848484,47.159090909090914
2016-02-04,52,193,133,378,13.756613756613756,51.05820105820106,35.18518518518518
2016-02-05,46,266,174,486,9.465020576131687,54.73251028806584,35.80246913580247
2016-02-06,46,173,117,336,13.690476190476192,51.488095238095234,34.82142857142857
2016-02-07,46,162,97,305,15.081967213114755,53.11475409836065,31.80327868852459
2016-02-08,64,420,106,590,10.847457627118644,71.1864406779661,17.966101694915253
2016-02-09,86,302,138,526,16.34980988593156,57.414448669201526,26.23574144486692
2016-02-10,60,268,139,467,12.84796573875803,57.38758029978587,29.764453961456105
2016-02-11,70,180,110,360,19.444444444444446,50.0,30.555555555555557
2016-02-12,593,382,301,1276,46.47335423197492,29.93730407523511,23.58934169278997
2016-02-13,71,138,104,313,22.683706070287542,44.08945686900959,33.22683706070288
2016-02-14,52,134,78,264,19.696969696969695,50.75757575757576,29.545454545454547
2016-02-15,67,176,155,398,16.834170854271356,44.221105527638194,38.94472361809046
2016-02-16,69,283,154,506,13.636363636363635,55.92885375494071,30.434782608695656
2016-02-17,54,224,124,402,13.432835820895523,55.72139303482587,30.845771144278604
2016-02-18,84,196,147,427,19.672131147540984,45.90163934426229,34.42622950819672
2016-02-19,160,146,175,481,33.264033264033266,30.353430353430355,36.38253638253639
2016-02-20,64,145,132,341,18.7683284457478,42.52199413489736,38.70967741935484
2016-02-21,60,192,158,410,14.634146341463413,46.82926829268293,38.53658536585366
2016-02-22,61,218,160,439,13.895216400911162,49.65831435079727,36.44646924829157
2016-02-23,44,202,139,385,11.428571428571429,52.467532467532465,36.103896103896105
2016-02-24,47,181,99,327,14.37308868501529,55.35168195718655,30.275229357798167
2016-02-25,66,263,134,463,14.254859611231103,56.803455723542115,28.94168466522678
2016-02-26,70,175,125,370,18.91891891891892,47.2972972972973,33.78378378378378
2016-02-27,51,129,77,257,19.844357976653697,50.19455252918288,29.961089494163424
2016-02-28,43,131,112,286,15.034965034965033,45.8041958041958,39.16083916083916
2016-02-29,40,186,81,307,13.029315960912053,60.586319218241044,26.384364820846905
2016-03-01,41,196,109,346,11.849710982658959,56.64739884393064,31.502890173410403
2016-03-02,47,136,87,270,17.40740740740741,50.37037037037037,32.22222222222222
2016-03-03,45,179,92,316,14.240506329113925,56.64556962025317,29.11392405063291
2016-03-04,76,206,142,424,17.92452830188679,48.58490566037736,33.490566037735846
2016-03-05,30,158,104,292,10.273972602739725,54.109589041095894,35.61643835616438
2016-03-06,39,98,102,239,16.317991631799163,41.00418410041841,42.67782426778243
2016-03-07,62,168,167,397,15.617128463476071,42.31738035264483,42.0654911838791
2016-03-08,99,266,343,708,13.983050847457626,37.570621468926554,48.44632768361582
2016-03-09,54,154,174,382,14.136125654450263,40.31413612565445,45.54973821989529
2016-03-10,70,205,210,485,14.432989690721648,42.2680412371134,43.29896907216495
2016-03-11,51,214,149,414,12.318840579710146,51.690821256038646,35.990338164251206
2016-03-12,18,161,122,301,5.980066445182724,53.48837209302325,40.53156146179402
2016-03-13,52,178,147,377,13.793103448275861,47.214854111405835,38.9920424403183
2016-03-14,62,194,149,405,15.308641975308642,47.901234567901234,36.79012345679013
2016-03-15,38,248,145,431,8.816705336426914,57.540603248259856,33.64269141531322
2016-03-16,45,219,110,374,12.032085561497325,58.55614973262032,29.411764705882355
2016-03-17,50,154,111,315,15.873015873015872,48.888888888888886,35.23809523809524
2016-03-18,37,155,119,311,11.89710610932476,49.839228295819936,38.263665594855304
2016-03-19,39,150,135,324,12.037037037037036,46.2962962962963,41.66666666666667
2016-03-20,52,159,150,361,14.40443213296399,44.04432132963989,41.55124653739612
2016-03-21,36,173,153,362,9.94475138121547,47.790055248618785,42.26519337016575
2016-03-22,62,223,189,474,13.080168776371309,47.04641350210971,39.87341772151899
2016-03-23,49,216,143,408,12.009803921568627,52.94117647058824,35.049019607843135
2016-03-24,42,209,164,415,10.120481927710843,50.36144578313253,39.51807228915663
2016-03-25,53,132,100,285,18.596491228070175,46.31578947368421,35.08771929824561
2016-03-26,59,151,153,363,16.2534435261708,41.59779614325069,42.14876033057851
2016-03-27,46,123,155,324,14.19753086419753,37.96296296296296,47.839506172839506
2016-03-28,39,149,106,294,13.26530612244898,50.68027210884354,36.054421768707485
2016-03-29,41,132,134,307,13.355048859934854,42.99674267100978,43.648208469055376
2016-03-30,38,176,126,340,11.176470588235295,51.76470588235295,37.05882352941177
2016-03-31,45,166,584,795,5.660377358490567,20.88050314465409,73.45911949685534
2016-04-01,29,157,116,302,9.602649006622517,51.98675496688742,38.41059602649007
2016-04-02,23,106,61,190,12.105263157894736,55.78947368421052,32.10526315789474
2016-04-03,35,134,91,260,13.461538461538462,51.53846153846153,35.0
2016-04-04,61,160,109,330,18.484848484848484,48.484848484848484,33.03030303030303
2016-04-05,65,213,113,391,16.624040920716112,54.47570332480819,28.9002557544757
2016-04-06,39,197,139,375,10.4,52.53333333333333,37.06666666666666
2016-04-07,62,133,125,320,19.375,41.5625,39.0625
2016-04-08,41,168,112,321,12.77258566978193,52.336448598130836,34.890965732087224
2016-04-09,34,137,84,255,13.333333333333334,53.72549019607843,32.94117647058823
2016-04-10,35,183,123,341,10.263929618768328,53.665689149560116,36.070381231671554
2016-04-11,45,288,128,461,9.761388286334057,62.47288503253796,27.765726681127983
2016-04-12,64,241,114,419,15.274463007159905,57.51789976133651,27.20763723150358
2016-04-13,43,261,181,485,8.8659793814433,53.81443298969072,37.31958762886598
2016-04-14,58,201,137,396,14.646464646464647,50.75757575757576,34.5959595959596
2016-04-15,74,234,203,511,14.481409001956946,45.79256360078278,39.726027397260275
2016-04-16,66,601,89,756,8.73015873015873,79.4973544973545,11.772486772486772
2016-04-17,34,327,84,445,7.640449438202247,73.48314606741573,18.876404494382022
2016-04-18,69,226,107,402,17.16417910447761,56.21890547263681,26.616915422885572
2016-04-19,57,236,120,413,13.801452784503631,57.14285714285714,29.055690072639223
2016-04-20,86,312,130,528,16.28787878787879,59.09090909090909,24.62121212121212
2016-04-21,114,783,267,1164,9.793814432989691,67.26804123711341,22.938144329896907
2016-04-22,52,340,186,578,8.996539792387544,58.82352941176471,32.17993079584775
2016-04-23,50,223,149,422,11.848341232227488,52.843601895734594,35.308056872037916
2016-04-24,50,316,153,519,9.633911368015415,60.886319845857415,29.47976878612717
2016-04-25,52,173,135,360,14.444444444444443,48.05555555555556,37.5
2016-04-26,56,243,152,451,12.416851441241686,53.88026607538803,33.70288248337029
2016-04-27,59,174,161,394,14.974619289340103,44.16243654822335,40.86294416243655
2016-04-28,47,224,231,502,9.362549800796813,44.6215139442231,46.015936254980076
2016-04-29,64,217,166,447,14.317673378076062,48.54586129753915,37.13646532438479
2016-04-30,47,184,200,431,10.904872389791183,42.69141531322506,46.403712296983755
2016-05-01,45,116,105,266,16.917293233082706,43.609022556390975,39.473684210526315
2016-05-02,65,236,151,452,14.380530973451327,52.21238938053098,33.4070796460177
2016-05-03,40,211,103,354,11.299435028248588,59.6045197740113,29.09604519774011
2016-05-04,83,248,250,581,14.285714285714285,42.68502581755594,43.029259896729776
2016-05-05,57,173,189,419,13.60381861575179,41.288782816229116,45.10739856801909
2016-05-06,104,257,433,794,13.09823677581864,32.367758186397985,54.53400503778337
2016-05-07,66,168,162,396,16.666666666666664,42.42424242424242,40.909090909090914
2016-05-08,72,157,178,407,17.69041769041769,38.57493857493858,43.73464373464373
2016-05-09,61,180,149,390,15.64102564102564,46.15384615384615,38.205128205128204
2016-05-10,38,176,132,346,10.982658959537572,50.86705202312138,38.15028901734104
2016-05-11,102,230,186,518,19.69111969111969,44.4015444015444,35.907335907335906
2016-05-12,131,264,234,629,20.82670906200318,41.971383147853736,37.20190779014308
2016-05-13,80,240,270,590,13.559322033898304,40.67796610169492,45.76271186440678
2016-05-14,75,225,162,462,16.233766233766232,48.701298701298704,35.064935064935064
2016-05-15,47,148,108,303,15.51155115511551,48.84488448844885,35.64356435643564
2016-05-16,46,226,149,421,10.926365795724466,53.681710213776725,35.39192399049881
2016-05-17,55,263,99,417,13.189448441247004,63.06954436450839,23.741007194244602
2016-05-18,310,258,157,725,42.758620689655174,35.58620689655172,21.655172413793103
2016-05-19,107,217,148,472,22.66949152542373,45.97457627118644,31.35593220338983
2016-05-20,69,219,172,460,15.0,47.608695652173914,37.391304347826086
2016-05-21,49,146,118,313,15.654952076677317,46.64536741214057,37.69968051118211
2016-05-22,52,178,130,360,14.444444444444443,49.44444444444444,36.11111111111111
2016-05-23,86,220,165,471,18.259023354564754,46.70912951167728,35.03184713375796
2016-05-24,78,389,215,682,11.436950146627565,57.03812316715543,31.524926686217007
2016-05-25,105,275,195,575,18.26086956521739,47.82608695652174,33.91304347826087
2016-05-26,81,259,183,523,15.487571701720842,49.521988527724666,34.990439770554495
2016-05-27,57,277,184,518,11.003861003861005,53.47490347490348,35.521235521235525
2016-05-28,47,181,146,374,12.566844919786096,48.39572192513369,39.037433155080215
2016-05-29,59,132,128,319,18.495297805642632,41.37931034482759,40.12539184952978
2016-05-30,51,131,96,278,18.345323741007196,47.122302158273385,34.53237410071942
2016-05-31,68,230,134,432,15.74074074074074,53.24074074074075,31.01851851851852
2016-06-01,61,314,145,520,11.73076923076923,60.38461538461538,27.884615384615387
2016-06-02,58,294,134,486,11.934156378600823,60.49382716049383,27.572016460905353
2016-06-03,98,270,240,608,16.11842105263158,44.40789473684211,39.473684210526315
2016-06-04,60,163,200,423,14.184397163120568,38.53427895981088,47.28132387706856
2016-06-05,40,166,95,301,13.2890365448505,55.14950166112956,31.561461794019934
2016-06-06,67,271,115,453,14.79028697571744,59.82339955849889,25.386313465783665
2016-06-07,81,352,129,562,14.412811387900357,62.63345195729537,22.95373665480427
2016-06-08,84,191,118,393,21.374045801526716,48.60050890585242,30.025445292620866
2016-06-09,69,206,124,399,17.293233082706767,51.62907268170426,31.07769423558897
2016-06-10,55,186,210,451,12.195121951219512,41.24168514412417,46.56319290465632
2016-06-11,31,123,99,253,12.25296442687747,48.616600790513836,39.130434782608695
2016-06-12,115,400,195,710,16.19718309859155,56.33802816901409,27.464788732394368
2016-06-13,155,475,790,1420,10.915492957746478,33.45070422535211,55.633802816901415
2016-06-14,92,414,200,706,13.031161473087819,58.640226628895185,28.328611898016998
2016-06-15,78,709,171,958,8.1419624217119,74.00835073068893,17.849686847599163
2016-06-16,120,347,295,762,15.748031496062993,45.53805774278215,38.71391076115486
2016-06-17,82,305,197,584,14.04109589041096,52.226027397260275,33.73287671232877
2016-06-18,41,203,125,369,11.11111111111111,55.013550135501355,33.87533875338754
2016-06-19,69,177,114,360,19.166666666666668,49.166666666666664,31.666666666666664
2016-06-20,77,209,136,422,18.246445497630333,49.5260663507109,32.22748815165877
2016-06-21,54,248,161,463,11.663066954643629,53.56371490280778,34.77321814254859
2016-06-22,83,285,151,519,15.992292870905588,54.91329479768786,29.09441233140655
2016-06-23,98,195,215,508,19.291338582677163,38.38582677165354,42.322834645669296
2016-06-24,239,479,423,1141,20.946538124452236,41.980718667835234,37.072743207712534
2016-06-25,145,464,516,1125,12.88888888888889,41.24444444444445,45.86666666666667
2016-06-26,127,400,180,707,17.963224893917964,56.57708628005658,25.459688826025463
2016-06-27,96,289,169,554,17.328519855595665,52.166064981949454,30.505415162454874
2016-06-28,95,232,126,453,20.97130242825607,51.21412803532009,27.81456953642384
2016-06-29,86,274,168,528,16.28787878787879,51.89393939393939,31.818181818181817
2016-06-30,113,312,228,653,17.304747320061256,47.77947932618683,34.915773353751916
2016-07-01,74,268,160,502,14.741035856573706,53.38645418326693,31.872509960159363
2016-07-02,51,183,103,337,15.133531157270031,54.3026706231454,30.56379821958457
2016-07-03,53,175,141,369,14.363143631436316,47.425474254742554,38.21138211382114
2016-07-04,74,222,135,431,17.16937354988399,51.508120649651964,31.322505800464036
2016-07-05,61,285,140,486,12.551440329218108,58.64197530864198,28.80658436213992
2016-07-06,72,229,140,441,16.3265306122449,51.92743764172335,31.746031746031743
2016-07-07,83,456,194,733,11.323328785811732,62.21009549795361,26.46657571623465
2016-07-08,70,282,145,497,14.084507042253522,56.74044265593562,29.175050301810867
2016-07-09,55,243,166,464,11.85344827586207,52.370689655172406,35.775862068965516
2016-07-10,47,161,104,312,15.064102564102564,51.60256410256411,33.33333333333333
2016-07-11,52,307,196,555,9.36936936936937,55.31531531531532,35.31531531531532
2016-07-12,84,253,179,516,16.27906976744186,49.031007751937985,34.689922480620154
2016-07-13,64,220,162,446,14.349775784753364,49.327354260089685,36.32286995515695
2016-07-14,89,176,287,552,16.1231884057971,31.88405797101449,51.992753623188406
2016-07-15,58,202,204,464,12.5,43.53448275862069,43.96551724137931
2016-07-16,38,99,113,250,15.2,39.6,45.2
2016-07-17,36,141,164,341,10.557184750733137,41.348973607038126,48.09384164222874
2016-07-18,39,139,136,314,12.420382165605096,44.26751592356688,43.31210191082803
2016-07-19,85,186,186,457,18.599562363238512,40.70021881838075,40.70021881838075
2016-07-20,54,168,179,401,13.466334164588527,41.895261845386536,44.63840399002494
2016-07-21,61,165,127,353,17.280453257790366,46.742209631728045,35.977337110481585
2016-07-22,77,152,77,306,25.163398692810457,49.673202614379086,25.163398692810457
2016-07-23,25,217,52,294,8.503401360544217,73.80952380952381,17.687074829931973
2016-07-24,27,112,78,217,12.442396313364055,51.61290322580645,35.944700460829495
2016-07-25,42,209,95,346,12.138728323699421,60.40462427745664,27.45664739884393
2016-07-26,56,188,99,343,16.3265306122449,54.81049562682215,28.86297376093295
2016-07-27,77,154,181,412,18.689320388349515,37.37864077669903,43.932038834951456
2016-07-28,71,201,129,401,17.70573566084788,50.12468827930174,32.16957605985037
2016-07-29,49,144,141,334,14.67065868263473,43.11377245508982,42.21556886227545
2016-07-30,40,158,162,360,11.11111111111111,43.888888888888886,45.0
2016-07-31,52,131,142,325,16.0,40.30769230769231,43.69230769230769
2016-08-01,54,179,196,429,12.587412587412588,41.72494172494173,45.68764568764569
2016-08-02,77,195,152,424,18.160377358490564,45.990566037735846,35.84905660377358
2016-08-03,42,221,128,391,10.741687979539643,56.52173913043478,32.73657289002558
2016-08-04,57,245,127,429,13.286713286713287,57.10955710955711,29.603729603729604
2016-08-05,94,326,120,540,17.40740740740741,60.370370370370374,22.22222222222222
2016-08-06,60,529,130,719,8.344923504867872,73.57440890125174,18.08066759388039
2016-08-07,26,161,88,275,9.454545454545455,58.54545454545455,32.0
2016-08-08,71,228,116,415,17.10843373493976,54.93975903614457,27.951807228915666
2016-08-09,25,139,105,269,9.293680297397769,51.6728624535316,39.03345724907063
2016-08-10,31,166,105,302,10.264900662251655,54.966887417218544,34.7682119205298
2016-08-11,41,182,152,375,10.933333333333334,48.53333333333333,40.53333333333333
2016-08-12,41,232,154,427,9.601873536299765,54.332552693208434,36.0655737704918
2016-08-13,37,146,142,325,11.384615384615385,44.92307692307692,43.69230769230769
2016-08-14,28,113,83,224,12.5,50.44642857142857,37.05357142857143
2016-08-15,64,142,116,322,19.875776397515526,44.099378881987576,36.024844720496894
2016-08-16,52,214,168,434,11.981566820276496,49.30875576036866,38.70967741935484
2016-08-17,67,271,321,659,10.166919575113809,41.122913505311075,48.710166919575116
2016-08-18,48,190,166,404,11.881188118811881,47.02970297029702,41.089108910891085
2016-08-19,56,210,173,439,12.756264236902052,47.83599088838269,39.40774487471526
2016-08-20,44,136,114,294,14.965986394557824,46.25850340136054,38.775510204081634
2016-08-21,32,101,82,215,14.883720930232558,46.97674418604651,38.139534883720934
2016-08-22,66,160,272,498,13.253012048192772,32.1285140562249,54.61847389558233
2016-08-23,656,790,247,1693,38.747784997046665,46.66272888363851,14.589486119314826
2016-08-24,70,229,179,478,14.644351464435147,47.90794979079498,37.44769874476987
2016-08-25,61,174,146,381,16.010498687664043,45.66929133858268,38.320209973753286
2016-08-26,63,156,148,367,17.166212534059948,42.50681198910082,40.32697547683924
2016-08-27,41,157,94,292,14.04109589041096,53.76712328767124,32.19178082191781
2016-08-28,25,107,46,178,14.04494382022472,60.1123595505618,25.842696629213485
2016-08-29,36,115,79,230,15.65217391304348,50.0,34.34782608695652
2016-08-30,37,150,101,288,12.847222222222221,52.083333333333336,35.06944444444444
2016-08-31,35,153,88,276,12.681159420289855,55.434782608695656,31.88405797101449
2016-09-01,23,169,66,258,8.914728682170542,65.50387596899225,25.581395348837212
2016-09-02,30,168,109,307,9.77198697068404,54.72312703583062,35.50488599348534
2016-09-03,27,129,49,205,13.170731707317074,62.926829268292686,23.902439024390244
2016-09-04,28,151,57,236,11.864406779661017,63.983050847457626,24.152542372881356
2016-09-05,36,150,86,272,13.23529411764706,55.14705882352941,31.61764705882353
2016-09-06,33,157,88,278,11.870503597122301,56.4748201438849,31.654676258992804
2016-09-07,20,203,77,300,6.666666666666667,67.66666666666666,25.666666666666664
2016-09-08,19,188,84,291,6.529209621993128,64.60481099656357,28.865979381443296
2016-09-09,54,139,62,255,21.176470588235293,54.509803921568626,24.313725490196077
2016-09-10,22,87,76,185,11.891891891891893,47.02702702702703,41.08108108108108
2016-09-11,22,63,49,134,16.417910447761194,47.01492537313433,36.56716417910448
2016-09-12,44,168,93,305,14.426229508196723,55.08196721311476,30.491803278688522
2016-09-13,58,198,91,347,16.714697406340058,57.06051873198847,26.22478386167147
2016-09-14,61,190,106,357,17.086834733893557,53.221288515406165,29.69187675070028
2016-09-15,44,192,89,325,13.538461538461538,59.07692307692308,27.384615384615387
2016-09-16,48,141,88,277,17.328519855595665,50.90252707581227,31.768953068592058
2016-09-17,34,98,66,198,17.17171717171717,49.494949494949495,33.33333333333333
2016-09-18,49,103,84,236,20.76271186440678,43.64406779661017,35.59322033898305
2016-09-19,37,184,101,322,11.490683229813664,57.14285714285714,31.366459627329192
2016-09-20,57,171,101,329,17.325227963525837,51.97568389057751,30.69908814589666
2016-09-21,39,151,132,322,12.111801242236025,46.8944099378882,40.993788819875775
2016-09-22,35,183,121,339,10.32448377581121,53.98230088495575,35.693215339233035
2016-09-23,46,230,83,359,12.813370473537605,64.06685236768801,23.119777158774372
2016-09-24,113,128,220,461,24.5119305856833,27.765726681127983,47.722342733188725
2016-09-25,43,112,81,236,18.220338983050848,47.45762711864407,34.32203389830508
2016-09-26,55,184,149,388,14.175257731958762,47.42268041237113,38.402061855670105
2016-09-27,42,197,176,415,10.120481927710843,47.46987951807229,42.40963855421687
2016-09-28,38,137,90,265,14.339622641509434,51.698113207547166,33.9622641509434
2016-09-29,41,174,160,375,10.933333333333334,46.400000000000006,42.66666666666667
2016-09-30,36,164,130,330,10.909090909090908,49.696969696969695,39.39393939393939
