Date,Negative,Positive,Neutral,Total,Percentage_neg,Percentage_pos,Percentage_neutr
2019-10-01,177,346,86,609,29.064039408866993,56.81444991789819,14.12151067323481
2019-10-02,187,386,101,674,27.74480712166172,57.27002967359051,14.985163204747776
2019-10-03,205,409,109,723,28.354080221300137,56.56984785615491,15.076071922544951
2019-10-04,246,455,113,814,30.22113022113022,55.8968058968059,13.882063882063884
2019-10-05,169,289,63,521,32.437619961612285,55.470249520153544,12.092130518234164
2019-10-06,212,385,89,686,30.903790087463555,56.12244897959183,12.973760932944606
2019-10-07,171,354,85,610,28.0327868852459,58.032786885245905,13.934426229508196
2019-10-08,294,459,109,862,34.106728538283065,53.24825986078886,12.645011600928074
2019-10-09,229,525,115,869,26.352128883774455,60.414269275028765,13.23360184119678
2019-10-10,247,468,111,826,29.90314769975787,56.65859564164649,13.438256658595641
2019-10-11,183,332,102,617,29.65964343598055,53.80875202593193,16.53160453808752
2019-10-12,148,271,75,494,29.959514170040485,54.8582995951417,15.182186234817813
2019-10-13,171,329,81,581,29.43201376936317,56.62650602409639,13.941480206540447
2019-10-14,169,368,90,627,26.953748006379584,58.69218500797449,14.354066985645932
2019-10-15,230,418,114,762,30.183727034120732,54.85564304461942,14.960629921259844
2019-10-16,202,416,112,730,27.671232876712327,56.986301369863014,15.342465753424658
2019-10-17,249,563,115,927,26.860841423948216,60.73354908306364,12.405609492988134
2019-10-18,243,544,111,898,27.060133630289535,60.57906458797328,12.360801781737193
2019-10-19,367,732,149,1248,29.407051282051285,58.65384615384615,11.939102564102564
2019-10-20,311,627,134,1072,29.011194029850746,58.48880597014925,12.5
2019-10-21,258,491,119,868,29.723502304147466,56.5668202764977,13.709677419354838
2019-10-22,326,696,116,1138,28.646748681898064,61.15992970123023,10.193321616871705
2019-10-23,289,677,91,1057,27.341532639545886,64.0491958372753,8.609271523178808
2019-10-24,301,760,103,1164,25.859106529209626,65.29209621993127,8.848797250859107
2019-10-25,284,667,114,1065,26.666666666666668,62.629107981220656,10.704225352112676
2019-10-26,187,382,91,660,28.333333333333332,57.878787878787875,13.787878787878787
2019-10-27,234,542,108,884,26.47058823529412,61.31221719457014,12.217194570135746
2019-10-28,422,757,108,1287,32.78943278943279,58.81895881895882,8.391608391608392
2019-10-29,520,2297,147,2964,17.543859649122805,77.4966261808367,4.959514170040486
2019-10-30,391,1487,131,2009,19.46241911398706,74.01692384270781,6.5206570433051265
2019-10-31,448,1070,122,1640,27.31707317073171,65.2439024390244,7.439024390243902
2019-11-01,330,840,136,1306,25.267993874425727,64.31852986217457,10.413476263399694
2019-11-02,255,583,110,948,26.89873417721519,61.49789029535865,11.60337552742616
2019-11-03,269,726,89,1084,24.81549815498155,66.97416974169742,8.210332103321033
2019-11-04,261,747,122,1130,23.097345132743364,66.10619469026548,10.79646017699115
2019-11-05,291,734,132,1157,25.151253241140882,63.439930855661196,11.408815903197926
2019-11-06,267,794,143,1204,22.17607973421927,65.9468438538206,11.877076411960132
2019-11-07,307,831,160,1298,23.651771956856702,64.02157164869028,12.326656394453005
2019-11-08,302,841,124,1267,23.83583267561168,66.37726913970008,9.78689818468824
2019-11-09,261,566,101,928,28.125,60.991379310344826,10.883620689655173
2019-11-10,244,528,85,857,28.47141190198366,61.61026837806302,9.918319719953326
2019-11-11,331,935,131,1397,23.693629205440228,66.92913385826772,9.377236936292055
2019-11-12,269,817,161,1247,21.57177225340818,65.51724137931035,12.910986367281478
2019-11-13,390,814,350,1554,25.096525096525095,52.38095238095239,22.52252252252252
2019-11-14,794,1612,965,3371,23.553841590032633,47.819638089587656,28.62652032037971
2019-11-15,612,1460,655,2727,22.442244224422442,53.53868720205354,24.01906857352402
2019-11-16,501,1066,709,2276,22.012302284710017,46.836555360281196,31.151142355008787
2019-11-17,557,1147,707,2411,23.10244711737868,47.573620904189134,29.32393197843219
2019-11-18,595,1163,630,2388,24.916247906197654,48.70184254606365,26.38190954773869
2019-11-19,599,1390,686,2675,22.39252336448598,51.96261682242991,25.644859813084114
2019-11-20,606,1182,664,2452,24.71451876019576,48.20554649265905,27.07993474714519
2019-11-21,654,1287,594,2535,25.79881656804734,50.76923076923077,23.431952662721894
2019-11-22,622,1152,542,2316,26.856649395509496,49.740932642487046,23.402417962003454
2019-11-23,488,970,446,1904,25.630252100840334,50.9453781512605,23.42436974789916
2019-11-24,606,1167,737,2510,24.143426294820717,46.49402390438247,29.36254980079681
2019-11-25,653,1393,667,2713,24.06929598230741,51.345374124585334,24.58532989310726
2019-11-26,661,1562,695,2918,22.6525017135024,53.529814941740916,23.81768334475668
2019-11-27,624,1311,638,2573,24.251846094053633,50.95219588029537,24.79595802565099
2019-11-28,628,1425,720,2773,22.646952758745044,51.38838802740714,25.964659213847817
2019-11-29,596,1132,522,2250,26.48888888888889,50.3111111111111,23.200000000000003
2019-11-30,476,985,440,1901,25.03945291951604,51.81483429773803,23.14571278274592
2019-12-01,618,1089,594,2301,26.857887874837026,47.327249022164274,25.814863102998697
2019-12-02,696,1275,753,2724,25.55066079295154,46.80616740088105,27.6431718061674
2019-12-03,588,1172,606,2366,24.85207100591716,49.53508030431107,25.612848689771766
2019-12-04,564,1154,566,2284,24.69352014010508,50.525394045534156,24.78108581436077
2019-12-05,671,1533,803,3007,22.314599268373794,50.981044230129704,26.704356501496505
2019-12-06,664,1319,695,2678,24.794622852875282,49.25317401045557,25.952203136669155
2019-12-07,602,1160,635,2397,25.114726741760535,48.393825615352526,26.49144764288694
2019-12-08,650,1308,717,2675,24.299065420560748,48.89719626168224,26.80373831775701
2019-12-09,915,1825,906,3646,25.095995611629185,50.05485463521667,24.849149753154144
2019-12-10,871,2072,1026,3969,21.945074326026706,52.20458553791887,25.850340136054424
2019-12-11,1102,2683,1271,5056,21.795886075949365,53.06566455696202,25.138449367088604
2019-12-12,1676,7102,1491,10269,16.320966014217547,69.15960658291947,14.519427402862986
2019-12-13,10800,25587,17033,53420,20.217147135904156,47.8977910894796,31.885061774616247
2019-12-14,2208,5443,2992,10643,20.746030254627453,51.14159541482665,28.112374330545897
2019-12-15,1623,3218,1621,6462,25.11606313834726,49.79882389353141,25.085112968121326
2019-12-16,1326,2754,1194,5274,25.14220705346985,52.218430034129696,22.639362912400454
2019-12-17,905,1928,938,3771,23.998939273402282,51.12702201007691,24.874038716520815
2019-12-18,773,1609,758,3140,24.61783439490446,51.242038216560516,24.14012738853503
2019-12-19,675,1624,719,3018,22.365805168986082,53.8104705102717,23.823724320742212
2019-12-20,618,1170,607,2395,25.80375782881002,48.8517745302714,25.344467640918577
2019-12-21,453,875,417,1745,25.959885386819487,50.1432664756447,23.896848137535816
2019-12-22,421,795,384,1600,26.3125,49.6875,24.0
2019-12-23,393,748,426,1567,25.079770261646456,47.73452456924059,27.185705169112957
2019-12-24,256,538,257,1051,24.357754519505235,51.18934348239772,24.45290199809705
2019-12-25,170,343,204,717,23.70990237099024,47.83821478382148,28.451882845188287
2019-12-26,194,408,218,820,23.65853658536585,49.75609756097561,26.585365853658537
2019-12-27,263,519,234,1016,25.88582677165354,51.082677165354326,23.031496062992126
2019-12-28,273,577,299,1149,23.759791122715406,50.217580504786774,26.022628372497824
2019-12-29,327,553,298,1178,27.75891341256367,46.94397283531409,25.29711375212224
2019-12-30,314,644,266,1224,25.653594771241828,52.614379084967325,21.73202614379085
2019-12-31,299,572,248,1119,26.720285969615727,51.117068811438784,22.162645218945485
2020-01-01,320,526,288,1134,28.21869488536155,46.38447971781305,25.396825396825395
2020-01-02,318,606,264,1188,26.767676767676768,51.010101010101,22.22222222222222
2020-01-03,277,539,252,1068,25.936329588014985,50.468164794007485,23.595505617977526
2020-01-04,277,468,214,959,28.884254431699684,48.800834202294055,22.314911366006257
2020-01-05,303,520,225,1048,28.912213740458014,49.61832061068702,21.469465648854964
2020-01-06,262,539,344,1145,22.882096069868997,47.07423580786026,30.043668122270745
2020-01-07,264,676,243,1183,22.31614539306847,57.14285714285714,20.540997464074387
2020-01-08,331,616,300,1247,26.543704891740177,49.39855653568564,24.057738572574177
2020-01-09,313,669,248,1230,25.447154471544714,54.390243902439025,20.16260162601626
2020-01-10,280,618,271,1169,23.952095808383234,52.86569717707442,23.182207014542342
2020-01-11,251,551,211,1013,24.777887462981244,54.3928923988154,20.829220138203354
2020-01-12,282,621,228,1131,24.93368700265252,54.907161803713535,20.159151193633953
2020-01-13,248,682,235,1165,21.28755364806867,58.540772532188846,20.171673819742487
2020-01-14,391,861,405,1657,23.596861798430897,51.96137598068798,24.44176222088111
2020-01-15,364,667,284,1315,27.680608365019012,50.72243346007605,21.59695817490494
2020-01-16,267,573,287,1127,23.691215616681454,50.84294587400178,25.465838509316768
2020-01-17,241,487,218,946,25.47568710359408,51.479915433403804,23.044397463002113
2020-01-18,219,459,204,882,24.829931972789115,52.04081632653062,23.12925170068027
2020-01-19,191,417,207,815,23.43558282208589,51.16564417177914,25.398773006134967
2020-01-20,227,511,290,1028,22.08171206225681,49.708171206225686,28.21011673151751
2020-01-21,290,504,233,1027,28.237585199610514,49.074975657254136,22.687439143135347
2020-01-22,255,564,259,1078,23.65491651205937,52.319109461966605,24.025974025974026
2020-01-23,269,532,223,1024,26.26953125,51.953125,21.77734375
2020-01-24,288,526,233,1047,27.507163323782237,50.238777459407835,22.25405921680993
2020-01-25,222,444,194,860,25.813953488372093,51.627906976744185,22.55813953488372
2020-01-26,281,410,210,901,31.187569367369587,45.50499445061043,23.307436182019977
2020-01-27,300,551,273,1124,26.690391459074732,49.02135231316726,24.288256227758005
2020-01-28,317,521,283,1121,28.278322925958964,46.47636039250669,25.245316681534348
2020-01-29,357,619,298,1274,28.021978021978022,48.58712715855573,23.390894819466247
2020-01-30,338,562,253,1153,29.314830875975716,48.74241110147442,21.942758022549867
2020-01-31,532,923,374,1829,29.086932750136686,50.464734827774734,20.448332422088573
2020-02-01,357,796,310,1463,24.401913875598087,54.40874914559125,21.189336978810662
2020-02-02,354,562,228,1144,30.944055944055943,49.12587412587413,19.93006993006993
2020-02-03,326,577,225,1128,28.900709219858157,51.152482269503544,19.9468085106383
2020-02-04,302,670,248,1220,24.75409836065574,54.91803278688525,20.327868852459016
2020-02-05,335,686,302,1323,25.321239606953895,51.85185185185185,22.826908541194253
2020-02-06,278,542,215,1035,26.859903381642514,52.367149758454104,20.77294685990338
2020-02-07,231,453,170,854,27.049180327868854,53.04449648711944,19.906323185011708
2020-02-08,237,494,196,927,25.5663430420712,53.29018338727076,21.143473570658035
2020-02-09,317,691,298,1306,24.272588055130168,52.90964777947933,22.817764165390507
2020-02-10,439,924,501,1864,23.551502145922747,49.57081545064378,26.87768240343348
2020-02-11,522,856,391,1769,29.508196721311474,48.38892029395139,22.10288298473714
2020-02-12,518,933,442,1893,27.363972530375065,49.28684627575277,23.34918119387216
2020-02-13,487,1031,691,2209,22.04617473970122,46.6727025803531,31.28112267994568
2020-02-14,360,687,386,1433,25.12212142358688,47.9413817166783,26.93649685973482
2020-02-15,286,531,276,1093,26.166514181152788,48.58188472095151,25.251601097895698
2020-02-16,418,615,337,1370,30.51094890510949,44.89051094890511,24.5985401459854
2020-02-17,421,695,364,1480,28.445945945945944,46.95945945945946,24.594594594594597
2020-02-18,399,716,359,1474,27.069199457259156,48.575305291723204,24.35549525101764
2020-02-19,462,863,421,1746,26.46048109965636,49.427262313860254,24.11225658648339
2020-02-20,405,782,424,1611,25.139664804469277,48.541278708876476,26.31905648665425
2020-02-21,425,783,377,1585,26.813880126182966,49.4006309148265,23.785488958990538
2020-02-22,342,690,290,1322,25.86989409984871,52.193645990922846,21.936459909228443
2020-02-23,426,870,377,1673,25.463239689181112,52.00239091452481,22.534369396294082
2020-02-24,419,703,338,1460,28.698630136986303,48.150684931506845,23.15068493150685
2020-02-25,453,782,406,1641,27.605118829981716,47.65386959171237,24.741011578305912
2020-02-26,426,828,473,1727,24.6670526925304,47.94441227562247,27.388535031847134
2020-02-27,515,962,598,2075,24.819277108433734,46.36144578313253,28.819277108433734
2020-02-28,436,760,551,1747,24.9570692615913,43.50314825414997,31.539782484258726
2020-02-29,463,805,536,1804,25.665188470066518,44.62305986696231,29.711751662971174
2020-03-01,528,1036,670,2234,23.634735899731425,46.37421665174575,29.991047448522828
2020-03-02,591,1031,678,2300,25.695652173913043,44.826086956521735,29.478260869565215
2020-03-03,635,1145,713,2493,25.47131969514641,45.928600080224626,28.60008022462896
2020-03-04,810,1387,805,3002,26.98201199200533,46.20253164556962,26.81545636242505
2020-03-05,670,1138,700,2508,26.71451355661882,45.374800637958536,27.91068580542265
2020-03-06,578,917,670,2165,26.697459584295615,42.35565819861432,30.94688221709007
2020-03-07,440,760,497,1697,25.928108426635237,44.78491455509723,29.286977018267528
2020-03-08,491,786,574,1851,26.526202052944353,42.463533225283626,31.010264721772014
2020-03-09,642,971,674,2287,28.071709663314387,42.457367730651505,29.470922606034105
2020-03-10,974,1577,988,3539,27.521898841480645,44.56061034190449,27.917490816614865
2020-03-11,985,2983,1551,5519,17.847436129733648,54.04964667512231,28.10291719514405
2020-03-12,1088,1852,1401,4341,25.06334945865008,42.662980879981575,32.273669661368345
2020-03-13,792,1318,1081,3191,24.81980570354121,41.3036665622062,33.87652773425259
2020-03-14,622,922,779,2323,26.77572105036591,39.690055962117945,33.534222987516145
2020-03-15,734,1187,772,2693,27.255848496101002,44.07723728184181,28.666914222057184
2020-03-16,741,1179,939,2859,25.918153200419724,41.23819517313746,32.84365162644281
2020-03-17,618,1160,834,2612,23.66003062787136,44.4104134762634,31.929555895865235
2020-03-18,550,977,785,2312,23.78892733564014,42.25778546712803,33.95328719723184
2020-03-19,563,900,667,2130,26.43192488262911,42.25352112676056,31.314553990610328
2020-03-20,648,1020,759,2427,26.699629171817058,42.027194066749075,31.27317676143387
2020-03-21,555,775,523,1853,29.951430113329735,41.824069077172155,28.22450080949811
2020-03-22,673,799,695,2167,31.056760498384868,36.871250576834335,32.071988924780804
2020-03-23,742,1163,1050,2955,25.109983079526227,39.357021996615906,35.53299492385787
2020-03-24,542,1006,838,2386,22.715842414082147,42.162615255658004,35.12154233025985
2020-03-25,571,980,633,2184,26.144688644688646,44.871794871794876,28.983516483516485
2020-03-26,611,1007,791,2409,25.36322125363221,41.801577418015775,32.835201328352014
2020-03-27,1102,7942,1838,10882,10.126814923727256,72.98290755375851,16.890277522514243
2020-03-28,738,1259,731,2728,27.052785923753664,46.151026392961874,26.796187683284455
2020-03-29,625,1225,775,2625,23.809523809523807,46.666666666666664,29.523809523809526
2020-03-30,603,1089,772,2464,24.4724025974026,44.19642857142857,31.33116883116883
2020-03-31,481,896,649,2026,23.74136229022705,44.22507403751234,32.03356367226061
2020-04-01,675,1041,716,2432,27.754934210526315,42.80427631578947,29.44078947368421
2020-04-02,746,1089,887,2722,27.406318883174137,40.00734753857458,32.586333578251285
2020-04-03,683,1151,855,2689,25.399776868724434,42.804016362960205,31.79620676831536
2020-04-04,1130,2653,1264,5047,22.389538339607686,52.56588072122052,25.044580939171784
2020-04-05,804,1825,1611,4240,18.962264150943398,43.04245283018868,37.99528301886792
2020-04-06,1293,2408,3773,7474,17.2999732405673,32.21835697083222,50.48166978860048
2020-04-07,1135,1898,2009,5042,22.510908369694565,37.64379214597382,39.84529948433161
2020-04-08,974,1584,1150,3708,26.26752966558792,42.71844660194174,31.014023732470335
2020-04-09,817,1461,1418,3696,22.104978354978357,39.52922077922078,38.365800865800864
2020-04-10,817,1397,1021,3235,25.25502318392581,43.183925811437405,31.561051004636788
2020-04-11,813,1300,1058,3171,25.63859981078524,40.99653106275623,33.36486912645853
2020-04-12,1063,1683,1963,4709,22.57379486090465,35.74007220216607,41.68613293692928
2020-04-13,1424,1760,1261,4445,32.03599550056243,39.595050618672666,28.368953880764902
2020-04-14,915,1306,892,3113,29.392868615483458,41.95309990362993,28.654031480886605
2020-04-15,970,1548,2015,4533,21.398632252371495,34.149569821310386,44.45179792631811
2020-04-16,882,1556,1556,3994,22.083124687030544,38.958437656484726,38.958437656484726
2020-04-17,866,1243,946,3055,28.34697217675941,40.687397708674304,30.965630114566284
2020-04-18,1001,1576,1150,3727,26.858062785081838,42.286020928360614,30.855916286557555
2020-04-19,990,1493,1085,3568,27.746636771300448,41.84417040358744,30.409192825112108
2020-04-20,731,1166,787,2684,27.235469448584205,43.44262295081967,29.321907600596127
2020-04-21,723,1119,819,2661,27.17023675310034,42.05186020293123,30.777903043968436
2020-04-22,808,1300,1029,3137,25.75709276378706,41.44086707044947,32.80204016576347
2020-04-23,731,1075,836,2642,27.668433005299015,40.6888720666162,31.642694928084786
2020-04-24,692,1058,768,2518,27.482128673550438,42.0174741858618,30.500397140587772
2020-04-25,666,910,692,2268,29.365079365079367,40.123456790123456,30.511463844797177
2020-04-26,691,1054,916,2661,25.967681322810975,39.60916948515595,34.42314919203307
2020-04-27,700,1249,1146,3095,22.617124394184167,40.35541195476575,37.02746365105008
2020-04-28,920,1346,909,3175,28.976377952755904,42.39370078740157,28.629921259842522
2020-04-29,827,1436,1038,3301,25.05301423810966,43.501969100272646,31.445016661617693
2020-04-30,880,1228,894,3002,29.313790806129248,40.90606262491672,29.78014656895403
2020-05-01,791,1241,915,2947,26.840855106888363,42.11062097047845,31.048523922633187
2020-05-02,619,971,722,2312,26.773356401384085,41.998269896193776,31.228373702422147
2020-05-03,676,1025,754,2455,27.535641547861506,41.75152749490835,30.712830957230143
2020-05-04,643,1073,1113,2829,22.72887946270767,37.92859667727112,39.34252386002121
2020-05-05,859,1189,928,2976,28.864247311827956,39.95295698924731,31.182795698924732
2020-05-06,910,1439,1074,3423,26.58486707566462,42.039146947122404,31.375985977212974
2020-05-07,902,1380,979,3261,27.660226924256364,42.318307267709294,30.021465808034346
2020-05-08,671,1046,746,2463,27.243199350385712,42.468534307754766,30.288266341859522
2020-05-09,768,1008,713,2489,30.855765367617515,40.49819204499799,28.64604258738449
2020-05-10,1329,1751,1637,4717,28.174687301250795,37.12105151579394,34.70426118295527
2020-05-11,1101,1587,1369,4057,27.138279516884396,39.1175745624846,33.744145920631006
2020-05-12,890,1282,948,3120,28.525641025641026,41.08974358974359,30.384615384615383
2020-05-13,833,1278,1002,3113,26.75875361387729,41.053646000642466,32.187600385480245
2020-05-14,921,1236,825,2982,30.885311871227366,41.4486921529175,27.66599597585513
2020-05-15,816,1269,896,2981,27.373364642737336,42.569607514256965,30.057027843005702
2020-05-16,862,1221,812,2895,29.775474956822105,42.17616580310881,28.048359240069086
2020-05-17,1327,1710,1125,4162,31.883709754925516,41.0860163382989,27.030273906775587
2020-05-18,1088,1593,1109,3790,28.707124010554093,42.031662269129285,29.26121372031662
2020-05-19,1271,1771,1142,4184,30.377629063097515,42.327915869980885,27.294455066921607
2020-05-20,1145,1727,1189,4061,28.195025855700568,42.52647131248461,29.278502831814823
2020-05-21,1281,1568,1079,3928,32.61201629327902,39.91853360488798,27.469450101832994
2020-05-22,1065,1389,1054,3508,30.359179019384264,39.59521094640821,30.045610034207527
2020-05-23,1378,1830,1270,4478,30.77266636891469,40.866458240285844,28.36087539079946
2020-05-24,2118,2931,2058,7107,29.80160405234276,41.24102997045166,28.957365977205573
2020-05-25,2140,2752,6157,11049,19.368268621594716,24.90723142365825,55.72449995474703
2020-05-26,1750,2594,3134,7478,23.401979138807167,34.68841936346617,41.90960149772667
2020-05-27,2447,2369,2604,7420,32.97843665768194,31.92722371967655,35.094339622641506
2020-05-28,2046,2159,2192,6397,31.983742379240272,33.75019540409567,34.26606221666406
2020-05-29,1284,1688,1668,4640,27.672413793103452,36.37931034482759,35.94827586206897
2020-05-30,1328,1753,2335,5416,24.519940915805023,32.36706056129985,43.112998522895126
2020-05-31,1390,1806,1952,5148,27.000777000777,35.08158508158508,37.91763791763792
2020-06-01,1331,1818,1850,4999,26.625325065013,36.36727345469094,37.00740148029606
2020-06-02,2243,2507,2713,7463,30.05493769261691,33.59238911965697,36.35267318772611
2020-06-03,2327,2956,9494,14777,15.747445354266764,20.00406036407931,64.24849428165392
2020-06-04,1935,2514,2736,7185,26.931106471816285,34.98956158663883,38.079331941544886
2020-06-05,1777,2206,1926,5909,30.072770350313082,37.332882044339144,32.59434760534777
2020-06-06,1519,1976,1619,5114,29.70277669143527,38.63903011341416,31.65819319515057
2020-06-07,1619,2398,2208,6225,26.00803212851406,38.52208835341365,35.46987951807229
2020-06-08,1892,2355,2760,7007,27.001569858712713,33.60924789496218,39.389182246325106
2020-06-09,2678,2671,3324,8673,30.877435720050734,30.79672546984896,38.32583881010031
2020-06-10,2075,2210,2485,6770,30.64992614475628,32.64401772525849,36.70605612998523
2020-06-11,1648,2166,2010,5824,28.296703296703296,37.190934065934066,34.512362637362635
2020-06-12,1725,2244,1852,5821,29.63408349080914,38.55007730630476,31.815839202886103
2020-06-13,1658,2310,2263,6231,26.60889102872733,37.07270101107367,36.318407960199
2020-06-14,1458,2100,2269,5827,25.02145186202162,36.03912819632744,38.93941994165094
2020-06-15,1419,1987,2042,5448,26.046255506607928,36.47209985315712,37.481644640234954
2020-06-16,1826,2621,2410,6857,26.62972145253026,38.22371299402071,35.14656555344903
2020-06-17,1608,2213,2262,6083,26.434325168502383,36.38007562058195,37.18559921091567
2020-06-18,1686,2241,2035,5962,28.27910097282791,37.5880576987588,34.132841328413285
2020-06-19,1409,2060,1987,5456,25.824780058651026,37.75659824046921,36.41862170087977
2020-06-20,1191,1710,1705,4606,25.857577073382544,37.12548849326965,37.01693443334781
2020-06-21,1298,1610,1374,4282,30.31293787949556,37.59925268566091,32.08780943484353
2020-06-22,1295,1933,1460,4688,27.62372013651877,41.23293515358362,31.14334470989761
2020-06-23,1347,1837,2051,5235,25.730659025787965,35.090735434574974,39.178605539637054
2020-06-24,1284,1855,1755,4894,26.236207601144258,37.903555373927254,35.86023702492848
2020-06-25,1635,2484,2060,6179,26.460592328855803,40.200679721637805,33.33872794950639
2020-06-26,1499,2113,1935,5547,27.023616369208582,38.09266270055886,34.883720930232556
2020-06-27,1490,2070,1889,5449,27.344466874655897,37.98862176546155,34.66691135988255
2020-06-28,1539,2271,2239,6049,25.442221854852043,37.54339560257894,37.01438254256902
2020-06-29,1575,2493,2439,6507,24.20470262793914,38.312586445366534,37.48271092669433
2020-06-30,1895,2796,2226,6917,27.39627005927425,40.422148330200955,32.181581610524795
2020-07-01,2004,3221,2610,7835,25.577536694320358,41.1104020421187,33.31206126356094
2020-07-02,1433,2184,1726,5343,26.820138498970614,40.87591240875913,32.303949092270265
2020-07-03,1339,1905,1821,5065,26.436327739387956,37.61105626850938,35.952615992102665
2020-07-04,1098,1310,1233,3641,30.156550398242242,35.9791266135677,33.86432298819006
2020-07-05,1235,1768,1355,4358,28.33868747131712,40.56906837999082,31.09224414869206
2020-07-06,1217,1728,1471,4416,27.558876811594203,39.130434782608695,33.3106884057971
2020-07-07,1206,1720,1515,4441,27.156045935600094,38.73001576221572,34.113938302184195
2020-07-08,1264,1931,1493,4688,26.96245733788396,41.19027303754266,31.847269624573375
2020-07-09,1251,4531,1642,7424,16.85075431034483,61.031788793103445,22.117456896551722
2020-07-10,1295,3492,1716,6503,19.91388589881593,53.698293095494385,26.38782100568968
2020-07-11,927,1636,1265,3828,24.21630094043887,42.73772204806687,33.04597701149425
2020-07-12,1160,1740,1369,4269,27.172639962520496,40.758959943780745,32.068400093698756
2020-07-13,1214,1961,1539,4714,25.753075943996606,41.599490878235045,32.64743317776835
2020-07-14,1331,1924,1585,4840,27.500000000000004,39.752066115702476,32.74793388429752
2020-07-15,1300,2063,1666,5029,25.850069596341218,41.02207198250149,33.127858421157285
2020-07-16,1764,3264,2500,7528,23.43251859723698,43.35812964930925,33.209351753453774
2020-07-17,1438,2266,2481,6185,23.249797898140663,36.637025060630556,40.11317704122878
2020-07-18,1103,1481,1173,3757,29.358530742613787,39.41974980037264,31.221719457013574
2020-07-19,1110,1698,1279,4087,27.159285539515537,41.54636652801566,31.294347932468803
2020-07-20,1157,1659,1475,4291,26.963411792123047,38.66231647634584,34.37427173153112
2020-07-21,2692,3388,2665,8745,30.783304745568895,38.742138364779876,30.47455688965123
2020-07-22,2081,2913,2255,7249,28.707407918333562,40.18485308318389,31.10773899848255
2020-07-23,1760,2797,1992,6549,26.874331959077725,42.70881050542067,30.416857535501602
2020-07-24,1249,2154,2304,5707,21.885403889959697,37.74312248116348,40.37147362887682
2020-07-25,1282,1998,1795,5075,25.261083743842367,39.36945812807882,35.36945812807882
2020-07-26,1370,2164,1681,5215,26.270373921380635,41.49568552253116,32.23394055608821
2020-07-27,1255,2023,1468,4746,26.4433206911083,42.62536873156343,30.931310577328276
2020-07-28,954,1766,1460,4180,22.822966507177036,42.248803827751196,34.92822966507177
2020-07-29,1076,1781,1500,4357,24.695891668579296,40.87675005737893,34.42735827404177
2020-07-30,1483,2096,2017,5596,26.50107219442459,37.45532523230879,36.04360257326662
2020-07-31,1289,1640,1401,4330,29.769053117782914,37.87528868360277,32.355658198614314
2020-08-01,968,1394,1200,3562,27.17574396406513,39.13531723750702,33.68893879842785
2020-08-02,1010,1440,1123,3573,28.267562272600056,40.302267002518896,31.43017072488105
2020-08-03,1034,1465,1788,4287,24.119430837415443,34.17308140891066,41.7074877536739
2020-08-04,1099,1489,1456,4044,27.176063303659742,36.81998021760633,36.003956478733926
2020-08-05,1096,1639,1366,4101,26.725188978297975,39.965861984881734,33.30894903682029
2020-08-06,1697,2532,1640,5869,28.914636224229,43.14193218606236,27.943431589708638
2020-08-07,1727,2528,1959,6214,27.792082394592853,40.68233022207918,31.52558738332797
2020-08-08,1789,2595,1865,6249,28.628580572891664,41.52664426308209,29.844775164026245
2020-08-09,1718,2188,1515,5421,31.691569821066224,40.36155690831949,27.946873270614276
2020-08-10,1902,2488,1683,6073,31.31895274164334,40.968219990120204,27.712827268236456
2020-08-11,2001,2622,1877,6500,30.784615384615382,40.33846153846154,28.876923076923077
2020-08-12,2820,3543,2349,8712,32.36914600550964,40.66804407713499,26.962809917355372
2020-08-13,2093,2902,2134,7129,29.358956375368216,40.70697152475803,29.934072099873752
2020-08-14,1728,2329,1746,5803,29.77770118904015,40.13441323453386,30.08788557642599
2020-08-15,1789,2200,1959,5948,30.077336919973103,36.98722259583053,32.93544048419637
2020-08-16,2030,2421,2419,6870,29.54876273653566,35.24017467248908,35.21106259097525
2020-08-17,2086,2758,2866,7710,27.055771725032425,35.77172503242542,37.172503242542156
2020-08-18,1809,2535,2101,6445,28.068269976726146,39.332816136539954,32.598913886733904
2020-08-19,2022,2908,2432,7362,27.465362673186632,39.50013583265417,33.034501494159194
2020-08-20,1788,2559,2453,6800,26.294117647058822,37.63235294117647,36.0735294117647
2020-08-21,2411,2798,2675,7884,30.580923389142566,35.48959918822933,33.92947742262811
2020-08-22,1688,2235,1812,5735,29.43330427201395,38.97122929380994,31.59546643417611
2020-08-23,1751,2403,1864,6018,29.09604519774011,39.930209371884345,30.973745430375537
2020-08-24,1597,2576,2170,6343,25.17736087025067,40.6116979347312,34.21094119501813
2020-08-25,1816,2515,2075,6406,28.34842335310646,39.260068685607244,32.391507961286294
2020-08-26,1839,2637,2422,6898,26.659901420701654,38.228472020875614,35.111626558422735
2020-08-27,1912,2583,2242,6737,28.38058483004305,38.34050764435209,33.278907525604865
2020-08-28,1628,2438,1810,5876,27.705922396187884,41.490810074880876,30.803267528931244
2020-08-29,1364,1940,1466,4770,28.59538784067086,40.670859538784065,30.733752620545076
2020-08-30,1700,2338,1572,5610,30.303030303030305,41.67557932263814,28.02139037433155
2020-08-31,1550,2003,1469,5022,30.864197530864196,39.884508164078056,29.251294305057744
2020-09-01,1763,2918,1979,6660,26.47147147147147,43.81381381381381,29.714714714714713
2020-09-02,2388,3431,2824,8643,27.62929538354738,39.69686451463612,32.673840101816495
2020-09-03,3683,5093,4389,13165,27.975693125712116,38.685909608811244,33.338397265476644
2020-09-04,3187,4838,3798,11823,26.955933350249513,40.920240209760635,32.12382643998985
2020-09-05,2504,3839,2880,9223,27.149517510571396,41.62420036864361,31.226282120784994
2020-09-06,3429,4672,4672,12773,26.845690127612933,36.57715493619354,36.57715493619354
2020-09-07,4301,6331,6175,16807,25.59052775629202,37.66882846433034,36.74064377937764
2020-09-08,5182,8379,6939,20500,25.278048780487804,40.87317073170731,33.84878048780488
2020-09-09,5372,8135,7334,20841,25.776114389904514,39.033635622091076,35.19024998800441
2020-09-10,5070,7627,6175,18872,26.865197117422635,40.41437049597287,32.72043238660449
2020-09-11,4285,6856,5857,16998,25.208848099776443,40.33415695964231,34.45699494058124
2020-09-12,4328,5803,5291,15422,28.063804953961874,37.62806380495396,34.30813124108417
2020-09-13,4149,6171,4808,15128,27.425965097831835,40.791909042834476,31.78212585933369
2020-09-14,5303,7891,6439,19633,27.01064534202618,40.19253298018642,32.7968216777874
2020-09-15,5368,7241,6547,19156,28.022551680935475,37.80016704948841,34.17728126957611
2020-09-16,4215,5792,6839,16846,25.02077644544699,34.3820491511338,40.59717440341921
2020-09-17,3975,6078,7412,17465,22.759805324935588,34.80103063269396,42.43916404237045
2020-09-18,3339,5182,5585,14106,23.670778392173546,36.73614064936906,39.59308095845739
2020-09-19,2459,3729,3276,9464,25.982671174978865,39.40194420963652,34.61538461538461
2020-09-20,2893,3922,3381,10196,28.373872106708514,38.46606512357788,33.16006276971361
2020-09-21,3249,4708,4350,12307,26.399609978061267,38.25465182416511,35.34573819777363
2020-09-22,4382,6210,6511,17103,25.621236040460737,36.30941940010525,38.069344559434015
2020-09-23,4032,6148,6501,16681,24.171212757028957,36.85630357892213,38.972483664048916
2020-09-24,3574,5640,4476,13690,26.10664718772827,41.19795471146823,32.69539810080351
2020-09-25,2945,4802,3645,11392,25.851474719101127,42.15238764044944,31.99613764044944
2020-09-26,2635,4394,3085,10114,26.05299584734032,43.44473007712082,30.502274075538853
2020-09-27,2509,4273,3014,9796,25.61249489587587,43.61984483462638,30.767660269497753
2020-09-28,3850,4854,4288,12992,29.63362068965517,37.36145320197045,33.004926108374384
2020-09-29,3652,5645,4847,14144,25.820135746606336,39.91091628959276,34.268947963800905
2020-09-30,4212,5849,5736,15797,26.663290498195856,37.02601759827815,36.310691903525985
